あいかぎ	合いかぎ	抑制単語	合い鍵
あいかぎ	合いかぎ	抑制単語	合鍵
あいかぎ	合かぎ	抑制単語	合い鍵
あいかぎ	合かぎ	抑制単語	合鍵
あいかわらずすご	相変わらずすご	抑制単語	相変わらず凄
あいかわらずすごい	相変わらずすごい	抑制単語	相変わらず凄い
あいかわらずすごかっ	相変わらずすごかっ	抑制単語	相変わらず凄かっ
あいかわらずすごく	相変わらずすごく	抑制単語	相変わらず凄く
あいかわらずものすごい	相変わらずものすごい	抑制単語	相変わらずもの凄い
あいかわらずものすごい	相変わらずものすごい	抑制単語	相変わらず物凄い
あいがん	愛がん	抑制単語	愛玩
あいきょう	愛きょう	抑制単語	愛嬌
あいさつうんどう	あいさつ運動	抑制単語	挨拶運動
あいさつがわり	あいさつ代わり	抑制単語	挨拶代わり
あいさつじょう	あいさつ状	抑制単語	挨拶状
あいさつていど	あいさつ程度	抑制単語	挨拶程度
あいさつぶん	あいさつ文	抑制単語	挨拶文
あいずちをうち	相づちを打ち	抑制単語	相槌を打ち
あいちゃくわき	愛着わき	抑制単語	愛着湧き
あいづちをうち	相づちを打ち	抑制単語	相槌を打ち
あいびき	合いびき	抑制単語	合い挽き
あいびきにく	合いびき肉	抑制単語	合い挽き肉
あいびきにく	合いびき肉	抑制単語	合挽き肉
あいぶ	愛ぶ	抑制単語	愛撫
あいまいせい	あいまい性	抑制単語	曖昧性
あいまっ	相まっ	抑制単語	相俟っ
あいまつ	相まつ	抑制単語	相俟つ
あいろ	あい路	抑制単語	隘路
あおあざ	青あざ	抑制単語	青痣
あおかび	青かび	抑制単語	青黴
あおぎり	青切り	抑制単語	青桐
あおくま	青くま	抑制単語	青熊
あおげばとうとし	あおげば尊し	抑制単語	仰げば尊し!
あおざめ	青ざめ	抑制単語	青褪め
あおざめ	青ざめ	抑制単語	青褪め
あおざめる	青ざめる	抑制単語	青褪める
あおしそ	青しそ	抑制単語	青紫蘇
あおねぎ	青ねぎ	抑制単語	青葱
あおのり	青のり	抑制単語	青海苔
あおりたて	あおり立て	抑制単語	煽り立て
あおりたてる	あおり立てる	抑制単語	煽り立てる
あおりんご	青りんご	抑制単語	青林檎
あかさび	赤さび	抑制単語	赤錆
あかじそ	赤じそ	抑制単語	赤紫蘇
あかとんぼ	赤とんぼ	抑制単語	赤蜻蛉
あかぬけ	あか抜け	抑制単語	垢抜け
あかぬけ	あか抜け	抑制単語	垢抜け
あかぬけし	あか抜けし	抑制単語	垢抜けし
あかぬける	あか抜ける	抑制単語	垢抜ける
あかみそ	赤みそ	抑制単語	赤味噌
あかむけ	赤むけ	抑制単語	赤剥け
あかれんが	赤れんが	抑制単語	赤煉瓦
あがりかまち	上がりかまち	抑制単語	上がり框
あきらめかけ	あきらめ掛け	抑制単語	諦め掛け
あきれかえっ	あきれ返っ	抑制単語	呆れ返っ
あきれかえり	あきれ返り	抑制単語	呆れ返り
あきれかえる	あきれ返る	抑制単語	呆れ返る
あきれはて	あきれ果て	抑制単語	呆れ果て
あきれはてる	あきれ果てる	抑制単語	呆れ果てる
あくば	悪ば	抑制単語	悪罵
あくまで	飽くまで	抑制単語	飽く迄
あくまでも	飽くまでも	抑制単語	飽く迄も
あごがはずれ	あごが外れ	抑制単語	顎が外れ
あごでつかい	あごで使い	抑制単語	顎で使い
あごでつかう	あごで使う	抑制単語	顎で使う
あごでつかっ	あごで使っ	抑制単語	顎で使っ
あごでつかわ	あごで使わ	抑制単語	顎で使わ
あさくさのり	浅草のり	抑制単語	浅草海苔
あさひも	麻ひも	抑制単語	麻紐
あさもや	朝もや	抑制単語	朝靄
あざけりわらう	あざけり笑う	抑制単語	嘲り笑う
あざけりわらっ	あざけり笑っ	抑制単語	嘲り笑っ
あざわらい	あざ笑い	抑制単語	嘲笑い
あざわらう	あざ笑う	抑制単語	嘲笑う
あざわらっ	あざ笑っ	抑制単語	嘲笑っ
あざわらわ	あざ笑わ	抑制単語	嘲笑わ
あしかせ	足かせ	抑制単語	足枷
あしがすくみ	足がすくみ	抑制単語	足が竦み
あしがすくむ	足がすくむ	抑制単語	足が竦む
あしがすくん	足がすくん	抑制単語	足が竦ん
あしげ	足げ	抑制単語	足蹴
あしこぎ	足こぎ	抑制単語	足漕ぎ
あしさばき	足さばき	抑制単語	足捌き
あしたははれる	あしたは晴れる	抑制単語	明日は晴れる!
あしてまとい	足手まとい	抑制単語	足手纏い
あしなみそろえ	足並みそろえ	抑制単語	足並み揃え
あしなみをそろえ	足並みをそろえ	抑制単語	足並みを揃え
あしなみをそろえ	足並みをそろえ	抑制単語	足並みを揃え
あしなみをそろえる	足並みをそろえる	抑制単語	足並みを揃える
あしふき	足ふき	抑制単語	足拭き
あしまわり	足まわり	抑制単語	足廻り
あしもみ	足もみ	抑制単語	足揉み
あしやせ	脚やせ	抑制単語	脚痩せ
あしやせ	足やせ	抑制単語	足痩せ
あじわいあふれる	味わいあふれる	抑制単語	味わい溢れる
あせふき	汗ふき	抑制単語	汗拭き
あぜあみ	あぜ編み	抑制単語	畦編み
あぜみち	あぜ道	抑制単語	畦道
あぜん	あ然	抑制単語	唖然
あぜん	あ然	抑制単語	啞然
あそびがい	遊びがい	抑制単語	遊び甲斐
あそびほうけ	遊びほうけ	抑制単語	遊び惚け
あたたかいそば	温かいそば	抑制単語	温かい蕎麦
あたまなで	頭なで	抑制単語	頭撫で
あたまをかい	頭をかい	抑制単語	頭を掻い
あたまをかき	頭をかき	抑制単語	頭を掻き
あたまをかきかき	頭をかきかき	抑制単語	頭を掻き掻き
あたまをかく	頭をかく	抑制単語	頭を掻く
あたまをもたげ	頭をもたげ	抑制単語	頭を擡げ
あたまをもたげる	頭をもたげる	抑制単語	頭を擡げる
あだうち	あだ討ち	抑制単語	仇討
あだな	あだ名	抑制単語	仇名
あだな	あだ名	抑制単語	渾名
あっけ	あっ気	抑制単語	呆気
あっけにとられ	あっけに取られ	抑制単語	呆気に取られ
あっけにとられる	あっけに取られる	抑制単語	呆気に取られる
あっせん	あっ旋	抑制単語	斡旋
あつかん	熱かん	抑制単語	熱燗
あつまりいただき	集まりいただき	抑制単語	集まり戴き
あつめがい	集めがい	抑制単語	集め甲斐
あつものにこりてなますをふく	あつものに懲りてなますを吹く	抑制単語	羹に懲りて膾を吹く
あつらえむき	あつらえ向き	抑制単語	誂え向き
あつりょくなべ	圧力なべ	抑制単語	圧力鍋
あてさき	あて先	抑制単語	宛先
あてじ	あて字	抑制単語	宛字
あてな	あて名	抑制単語	宛名
あてはま	当てはま	抑制単語	当て嵌
あてはまっ	当てはまっ	抑制単語	当て嵌っ
あてはまっ	当てはまっ	抑制単語	当て嵌まっ
あてはまら	当てはまら	抑制単語	当て嵌まら
あてはまら	当てはまら	抑制単語	当て嵌ら
あてはまらん	当てはまらん	抑制単語	当て嵌まらん
あてはまり	当てはまり	抑制単語	当て嵌まり
あてはまり	当てはまり	抑制単語	当て嵌り
あてはまりそう	当てはまりそう	抑制単語	当て嵌まりそう
あてはまる	当てはまる	抑制単語	当て嵌まる
あてはまる	当てはまる	抑制単語	当て嵌る
あてはめ	当てはめ	抑制単語	当て嵌め
あてはめ	当てはめ	抑制単語	当て嵌め
あてはめよ	当てはめよ	抑制単語	当て嵌めよ
あてはめよう	当てはめよう	抑制単語	当て嵌めよう
あてはめる	当てはめる	抑制単語	当て嵌める
あてはめれ	当てはめれ	抑制単語	当て嵌めれ
あですがた	あで姿	抑制単語	艶姿
あとあとよい	あとあと良い	抑制単語	後々良い
あとがま	後がま	抑制単語	後釜
あとずり	後刷り	抑制単語	後摺
あとまわし	後まわし	抑制単語	後廻し
あばらぼね	あばら骨	抑制単語	肋骨
あばれまわっ	暴れまわっ	抑制単語	暴れ廻っ
あばれまわる	暴れまわる	抑制単語	暴れ廻る
あふれおち	あふれ落ち	抑制単語	溢れ落ち
あふれおちる	あふれ落ちる	抑制単語	溢れ落ちる
あふれかえっ	あふれ返っ	抑制単語	溢れ返っ
あふれかえり	あふれ返り	抑制単語	溢れ返り
あふれかえる	あふれ返る	抑制単語	溢れ返る
あふれださ	あふれ出さ	抑制単語	溢れ出さ
あふれださん	あふれ出さん	抑制単語	溢れ出さん
あふれだし	あふれ出し	抑制単語	溢れ出し
あふれだす	あふれ出す	抑制単語	溢れ出す
あふれで	あふれ出	抑制単語	溢れ出
あふれで	あふれ出	抑制単語	溢れ出
あふれでる	あふれ出る	抑制単語	溢れ出る
あふれでん	あふれ出ん	抑制単語	溢れ出ん
あぶらかす	油かす	抑制単語	油粕
あぶりださ	あぶり出さ	抑制単語	炙り出さ
あぶりださ	あぶり出さ	抑制単語	焙り出さ
あぶりだし	あぶり出し	抑制単語	炙り出し
あぶりだし	あぶり出し	抑制単語	炙り出し
あぶりだし	あぶり出し	抑制単語	焙り出し
あぶりだす	あぶり出す	抑制単語	炙り出す
あぶりだす	あぶり出す	抑制単語	焙り出す
あぶりだせ	あぶり出せ	抑制単語	炙り出せ
あぶりだせ	あぶり出せ	抑制単語	炙り出せ
あぶりだせる	あぶり出せる	抑制単語	炙り出せる
あぶりだそ	あぶり出そ	抑制単語	炙り出そ
あぶりで	あぶり出	抑制単語	炙り出
あぶりにく	あぶり肉	抑制単語	炙り肉
あぶりぶた	あぶり豚	抑制単語	炙り豚
あぶりもの	あぶり物	抑制単語	炙り物
あぶりやき	あぶり焼き	抑制単語	炙り焼き
あぶりやき	あぶり焼き	抑制単語	焙り焼き
あべかわもち	安倍川もち	抑制単語	安倍川餅
あほくさい	あほ臭い	抑制単語	阿呆臭い
あまかけ	天駆け	抑制単語	天翔
あまかける	天駆ける	抑制単語	天翔る
あまがさ	雨がさ	抑制単語	雨笠
あまざらし	雨ざらし	抑制単語	雨曝し
あまみそ	甘みそ	抑制単語	甘味噌
あまりにもったいない	余りにもったいない	抑制単語	余りに勿体ない
あまりにもったいない	余りにもったいない	抑制単語	余りに勿体無い
あみため	編みため	抑制単語	編み溜め
あみつない	編みつない	抑制単語	編み繋い
あみつなげ	編みつなげ	抑制単語	編み繋げ
あめあられ	雨あられ	抑制単語	雨霰
あめいろ	あめ色	抑制単語	飴色
あめにうたえば	雨にうたえば	抑制単語	雨に唄えば
あやおり	あや織り	抑制単語	綾織
あらいがい	洗いがい	抑制単語	洗い甲斐
あらいざらい	洗いざらい	抑制単語	洗い浚い
あらいざらし	洗いざらし	抑制単語	洗い晒し
あらしにつながり	荒らしにつながり	抑制単語	荒らしに繋がり
あるきがい	歩きがい	抑制単語	歩き甲斐
あるきなれ	歩きなれ	抑制単語	歩き馴れ
あわせのむ	併せのむ	抑制単語	併せ呑む
あわだた	あわ立た	抑制単語	粟立た
あわだち	あわ立ち	抑制単語	粟立ち
あわだっ	あわ立っ	抑制単語	粟立っ
あわだつ	あわ立つ	抑制単語	粟立つ
あんがいうれしい	案外うれしい	抑制単語	案外嬉しい
あんがいすごい	案外すごい	抑制単語	案外凄い
あんがいもろい	案外もろい	抑制単語	案外脆い
あんがいもろく	案外もろく	抑制単語	案外脆く
あんきも	あん肝	抑制単語	鮟肝
あんきょ	暗きょ	抑制単語	暗渠
あんたん	暗たん	抑制単語	暗澹
あんど	安ど	抑制単語	安堵
あんのじょうすごい	案の定すごい	抑制単語	案の定凄い
あんば	あん馬	抑制単語	鞍馬
あんぶん	あん分	抑制単語	按分
あんま	あん摩	抑制単語	按摩
あんらくいす	安楽いす	抑制単語	安楽椅子
いいなれ	言いなれ	抑制単語	言い馴れ
いいまわし	言いまわし	抑制単語	言い廻し
いいよどみ	言いよどみ	抑制単語	言い淀み
いいよどむ	言いよどむ	抑制単語	言い淀む
いいよどん	言いよどん	抑制単語	言い淀ん
いいよどん	言いよどん	抑制単語	言い澱ん
いえすごい	家すごい	抑制単語	家凄い
いかいよう	胃かいよう	抑制単語	胃潰瘍
いかりをおろし	いかりを下ろし	抑制単語	錨を下ろし
いがい	遺がい	抑制単語	遺骸
いがみあい	いがみ合い	抑制単語	啀み合い
いがみあう	いがみ合う	抑制単語	啀み合う
いがみあっ	いがみ合っ	抑制単語	啀み合っ
いがん	胃がん	抑制単語	胃癌
いきあい	行きあい	抑制単語	行き逢い
いきあう	行きあう	抑制単語	行き逢う
いきあっ	行きあっ	抑制単語	行き逢っ
いきがい	生きがい	抑制単語	生き甲斐
いきがい	生きがい	抑制単語	生甲斐
いきなれ	行きなれ	抑制単語	行き馴れ
いきはじをさらし	生き恥をさらし	抑制単語	生き恥を晒し
いきはじをさらす	生き恥をさらす	抑制単語	生き恥を晒す
いぐさ	い草	抑制単語	藺草
いけい	い敬	抑制単語	畏敬
いけいれん	胃けいれん	抑制単語	胃痙攣
いけにえ	生けにえ	抑制単語	生け贄
いけにえ	生けにえ	抑制単語	生贄
いげた	井げた	抑制単語	井桁
いし	い死	抑制単語	縊死
いしうす	石うす	抑制単語	石臼
いしずり	石刷り	抑制単語	石摺
いしばしをたたいてわたる	石橋をたたいて渡る	抑制単語	石橋を叩いて渡る
いしゅう	い集	抑制単語	蝟集
いじくりたおさ	いじくり倒さ	抑制単語	弄くり倒さ
いじくりたおさ	いじくり倒さ	抑制単語	弄り倒さ
いじくりたおし	いじくり倒し	抑制単語	弄くり倒し
いじくりたおし	いじくり倒し	抑制単語	弄り倒し
いじくりたおす	いじくり倒す	抑制単語	弄くり倒す
いじくりたおす	いじくり倒す	抑制単語	弄り倒す
いじくりまわさ	いじくり回さ	抑制単語	弄くり回さ
いじくりまわさ	いじくり回さ	抑制単語	弄り回さ
いじくりまわし	いじくり回し	抑制単語	弄くり回し
いじくりまわし	いじくり回し	抑制単語	弄り回し
いじくりまわす	いじくり回す	抑制単語	弄くり回す
いじくりまわす	いじくり回す	抑制単語	弄り回す
いじめころさ	いじめ殺さ	抑制単語	苛め殺さ
いじめぬい	いじめ抜い	抑制単語	苛め抜い
いじめぬか	いじめ抜か	抑制単語	苛め抜か
いじめぬき	いじめ抜き	抑制単語	苛め抜き
いじめぬく	いじめ抜く	抑制単語	苛め抜く
いじりこわす	いじり壊す	抑制単語	弄り壊す
いじりたおし	いじり倒し	抑制単語	弄り倒し
いじりまわし	いじり回し	抑制単語	弄り回し
いすくめ	射すくめ	抑制単語	射竦め
いたいたしい	痛いたしい	抑制単語	痛々しい
いただきたすかり	いただき助かり	抑制単語	戴き助かり
いただきよかっ	いただき良かっ	抑制単語	戴き良かっ
いたみしびれ	痛みしびれ	抑制単語	痛み痺れ
いたみにつながる	痛みにつながる	抑制単語	痛みに繋がる
いちいちじぶん	いちいち自分	抑制単語	一々自分
いちいちぜんぶ	いちいち全部	抑制単語	一々全部
いちおうすごい	一応すごい	抑制単語	一応凄い
いちがつごろ	一月ごろ	抑制単語	1月頃
いちごあじ	いちご味	抑制単語	苺味
いちごがら	いちご柄	抑制単語	苺柄
いちごだいふく	いちご大福	抑制単語	苺大福
いちごばたけ	いちご畑	抑制単語	苺畑
いちじきすごい	一時期すごい	抑制単語	一時期凄い
いちじきすごかっ	一時期すごかっ	抑制単語	一時期凄かっ
いちじきすごく	一時期すごく	抑制単語	一時期凄く
いちじごろ	一時ごろ	抑制単語	一時頃
いちぜん	一ぜん	抑制単語	一膳
いちそう	一そう	抑制単語	一艘
いちそろい	一そろい	抑制単語	一揃
いちつかみ	一つかみ	抑制単語	一掴み
いちばんうっとうしい	一番うっとうしい	抑制単語	一番鬱陶しい
いちばんうらやましい	一番うらやましい	抑制単語	一番羨ましい
いちばんうれし	一番うれし	抑制単語	一番嬉し
いちばんうれしい	一番うれしい	抑制単語	一番嬉しい
いちばんうれしかっ	一番うれしかっ	抑制単語	一番嬉しかっ
いちばんうれしく	一番うれしく	抑制単語	一番嬉しく
いちばんすごい	一番すごい	抑制単語	一番凄い
いちばんすごかっ	一番すごかっ	抑制単語	一番凄かっ
いちばんすごく	一番すごく	抑制単語	一番凄く
いちばんなじみぶかい	一番なじみ深い	抑制単語	一番馴染み深い
いちばんもったいない	一番もったいない	抑制単語	一番勿体ない
いちばんもったいない	一番もったいない	抑制単語	一番勿体無い
いちばんやり	一番やり	抑制単語	一番槍
いちべつ	一べつ	抑制単語	一瞥
いちまいかま	一枚かま	抑制単語	一枚噛ま
いちまいかん	一枚かん	抑制単語	一枚噛ん
いちもくりょうぜん	一目りょう然	抑制単語	一目瞭然
いちゆう	一ゆう	抑制単語	一揖
いちょうなみき	いちょう並木	抑制単語	銀杏並木
いっけた	一けた	抑制単語	一桁
いっしきそろえ	一式そろえ	抑制単語	一式揃え
いっしゅんすごい	一瞬すごい	抑制単語	一瞬凄い
いっそう	一そう	抑制単語	一艘
いっそううれしい	一層うれしい	抑制単語	一層嬉しい
いっそううれしく	一層うれしく	抑制単語	一層嬉しく
いっそうたくましく	一層たくましく	抑制単語	一層逞しく
いっそろい	一そろい	抑制単語	一揃
いったん	一たん	抑制単語	一旦
いったんじぶん	いったん自分	抑制単語	一旦自分
いったんすべて	いったん全て	抑制単語	一旦全て
いったんぜんいん	いったん全員	抑制単語	一旦全員
いったんぜんがく	いったん全額	抑制単語	一旦全額
いったんぜんぶ	いったん全部	抑制単語	一旦全部
いったんまえ	いったん前	抑制単語	一旦前
いっつかみ	一つかみ	抑制単語	一掴み
いっぽんやり	一本やり	抑制単語	一本槍
いつくしみにあふれ	慈しみにあふれ	抑制単語	慈しみに溢れ
いなかそば	田舎そば	抑制単語	田舎蕎麦
いなわら	稲わら	抑制単語	稲藁
いにょう	囲にょう	抑制単語	囲繞
いのちかけ	命かけ	抑制単語	命賭け
いのちごい	命ごい	抑制単語	命乞い
いのちをかけ	命をかけ	抑制単語	命を賭け
いのちをかけ	命をかけ	抑制単語	命を賭け
いのちをかけよ	命をかけよ	抑制単語	命を賭けよ
いのちをかけよう	命をかけよう	抑制単語	命を賭けよう
いのちをかける	命をかける	抑制単語	命を賭ける
いのちをかけろ	命をかけろ	抑制単語	命を賭けろ
いのちをつない	命をつない	抑制単語	命を繋い
いのちをつなぎ	命をつなぎ	抑制単語	命を繋ぎ
いのちをつなぐ	命をつなぐ	抑制単語	命を繋ぐ
いのちをつなごう	命をつなごう	抑制単語	命を繋ごう
いはい	位はい	抑制単語	位牌
いふ	い怖	抑制単語	畏怖
いふく	い服	抑制単語	畏服
いぶしぎん	いぶし銀	抑制単語	燻銀
いぶししあげ	いぶし仕上げ	抑制単語	燻し仕上げ
いぶしやき	いぶし焼き	抑制単語	燻し焼き
いまいましい	忌ま忌ましい	抑制単語	忌々しい
いまいましき	忌ま忌ましき	抑制単語	忌々しき
いまうれしい	今うれしい	抑制単語	今嬉しい
いますご	今すご	抑制単語	今凄
いますごい	今すごい	抑制単語	今凄い
いますごく	今すごく	抑制単語	今凄く
いまものすごい	今ものすごい	抑制単語	今もの凄い
いまものすごい	今ものすごい	抑制単語	今物凄い
いまものすごく	今ものすごく	抑制単語	今物凄く
いみうらやましい	意味うらやましい	抑制単語	意味羨ましい
いみすごい	意味すごい	抑制単語	意味凄い
いもずる	芋づる	抑制単語	芋蔓
いもずるしき	いもづる式	抑制単語	芋蔓式
いもづる	芋づる	抑制単語	芋蔓
いもづるしき	いもづる式	抑制単語	芋蔓式
いやしにつながり	癒しにつながり	抑制単語	癒しに繋がり
いやしにつながる	癒しにつながる	抑制単語	癒しに繋がる
いやまし	いや増し	抑制単語	弥増し
いらだた	いら立た	抑制単語	苛立た
いらだち	いら立ち	抑制単語	苛立ち
いらだっ	いら立っ	抑制単語	苛立っ
いらだつ	いら立つ	抑制単語	苛立つ
いりこ	いり子	抑制単語	炒り子
いれなじま	入れなじま	抑制単語	入れ馴染ま
いろあせ	色あせ	抑制単語	色褪せ
いろあせ	色あせ	抑制単語	色褪せ
いろあせあり	色あせあり	抑制単語	色褪せあり
いろあせあり	色あせあり	抑制単語	色褪せあり
いろあせあり	色あせ有り	抑制単語	色褪せ有り
いろあせし	色あせし	抑制単語	色褪せし
いろあせし	色あせし	抑制単語	色褪せし
いろあせする	色あせする	抑制単語	色褪せする
いろあせちゃっ	色あせちゃっ	抑制単語	色褪せちゃっ
いろあせにくい	色あせにくい	抑制単語	色褪せにくい
いろあせにくく	色あせにくく	抑制単語	色褪せにくく
いろあせによる	色あせによる	抑制単語	色褪せによる
いろあせる	色あせる	抑制単語	色褪せる
いろいろ	色いろ	抑制単語	色々
いろいろあたらしい	いろいろ新しい	抑制単語	色々新しい
いろいろあたらしい	いろいろ新しい	抑制単語	色々新しい
いろいろあたらしく	いろいろ新しく	抑制単語	色々新しく
いろいろあつい	いろいろ熱い	抑制単語	色々熱い
いろいろあつく	いろいろ熱く	抑制単語	色々熱く
いろいろあぶない	いろいろ危ない	抑制単語	色々危ない
いろいろあぶなかっ	いろいろ危なかっ	抑制単語	色々危なかっ
いろいろあまい	いろいろ甘い	抑制単語	色々甘い
いろいろあやしい	いろいろ怪しい	抑制単語	色々怪しい
いろいろあらい	いろいろ粗い	抑制単語	色々粗い
いろいろあらい	いろいろ荒い	抑制単語	色々荒い
いろいろありがとう	いろいろ有り難う	抑制単語	色々有り難う
いろいろあわただしく	いろいろ慌ただしく	抑制単語	色々慌ただしく
いろいろあん	いろいろ案	抑制単語	色々案
いろいろいい	いろいろ良い	抑制単語	色々良い
いろいろいかめしい	いろいろ厳しい	抑制単語	色々厳しい
いろいろいそがし	いろいろ忙し	抑制単語	色々忙し
いろいろいそがしい	いろいろ忙しい	抑制単語	色々忙しい
いろいろいそがしい	いろいろ忙しい	抑制単語	色々忙しい
いろいろいそがしかっ	いろいろ忙しかっ	抑制単語	色々忙しかっ
いろいろいそがしく	いろいろ忙しく	抑制単語	色々忙しく
いろいろいそがしくっ	いろいろ忙しくっ	抑制単語	色々忙しくっ
いろいろいたい	いろいろ痛い	抑制単語	色々痛い
いろいろいたく	いろいろ痛く	抑制単語	色々痛く
いろいろうまい	いろいろ上手い	抑制単語	色々上手い
いろいろうまく	いろいろ上手く	抑制単語	色々上手く
いろいろえら	いろいろ偉	抑制単語	色々偉
いろいろおいし	いろいろ美味し	抑制単語	色々美味し
いろいろおいしい	いろいろ美味しい	抑制単語	色々美味しい
いろいろおいしかっ	いろいろ美味しかっ	抑制単語	色々美味しかっ
いろいろおいしく	いろいろ美味しく	抑制単語	色々美味しく
いろいろおお	いろいろ多	抑制単語	色々多
いろいろおおい	いろいろ多い	抑制単語	色々多い
いろいろおおきく	いろいろ大きく	抑制単語	色々大きく
いろいろおおく	いろいろ多く	抑制単語	色々多く
いろいろおしい	いろいろ惜しい	抑制単語	色々惜しい
いろいろおそい	いろいろ遅い	抑制単語	色々遅い
いろいろおそく	いろいろ遅く	抑制単語	色々遅く
いろいろおそろしい	いろいろ恐ろしい	抑制単語	色々恐ろしい
いろいろおもい	いろいろ重い	抑制単語	色々重い
いろいろおもいでぶかい	いろいろ思い出深い	抑制単語	色々思い出深い
いろいろおもしろ	いろいろ面白	抑制単語	色々面白
いろいろおもしろい	いろいろ面白い	抑制単語	色々面白い
いろいろおもしろい	いろいろ面白い	抑制単語	色々面白い
いろいろおもしろかっ	いろいろ面白かっ	抑制単語	色々面白かっ
いろいろおもしろく	いろいろ面白く	抑制単語	色々面白く
いろいろおやすく	いろいろお安く	抑制単語	色々お安く
いろいろかなしい	いろいろ悲しい	抑制単語	色々悲しい
いろいろかなしく	いろいろ悲しく	抑制単語	色々悲しく
いろいろからい	いろいろ辛い	抑制単語	色々辛い
いろいろからかっ	いろいろ辛かっ	抑制単語	色々辛かっ
いろいろかるく	いろいろ軽く	抑制単語	色々軽く
いろいろかわい	いろいろ可愛	抑制単語	色々可愛
いろいろかわいい	いろいろ可愛い	抑制単語	色々可愛い
いろいろかわいかっ	いろいろ可愛かっ	抑制単語	色々可愛かっ
いろいろかわいく	いろいろ可愛く	抑制単語	色々可愛く
いろいろかんがいぶかい	いろいろ感慨深い	抑制単語	色々感慨深い
いろいろかんがいぶかかっ	いろいろ感慨深かっ	抑制単語	色々感慨深かっ
いろいろかんがいぶかく	いろいろ感慨深く	抑制単語	色々感慨深く
いろいろかんけいない	いろいろ関係ない	抑制単語	色々関係ない
いろいろきたない	いろいろ汚い	抑制単語	色々汚い
いろいろきなくさい	いろいろきな臭い	抑制単語	色々きな臭い
いろいろきびし	いろいろ厳し	抑制単語	色々厳し
いろいろきびしい	いろいろ厳しい	抑制単語	色々厳しい
いろいろきびしかっ	いろいろ厳しかっ	抑制単語	色々厳しかっ
いろいろきびしく	いろいろ厳しく	抑制単語	色々厳しく
いろいろきまずい	いろいろ気まずい	抑制単語	色々気まずい
いろいろきもちわるい	いろいろ気持ち悪い	抑制単語	色々気持ち悪い
いろいろきょうみぶかい	いろいろ興味深い	抑制単語	色々興味深い
いろいろきょうみぶかかっ	いろいろ興味深かっ	抑制単語	色々興味深かっ
いろいろきょうみぶかく	いろいろ興味深く	抑制単語	色々興味深く
いろいろくやしい	いろいろ悔しい	抑制単語	色々悔しい
いろいろくるしい	いろいろ苦しい	抑制単語	色々苦しい
いろいろくるしかっ	いろいろ苦しかっ	抑制単語	色々苦しかっ
いろいろくろい	いろいろ黒い	抑制単語	色々黒い
いろいろくわし	いろいろ詳し	抑制単語	色々詳し
いろいろくわしい	いろいろ詳しい	抑制単語	色々詳しい
いろいろくわしく	いろいろ詳しく	抑制単語	色々詳しく
いろいろこい	いろいろ濃い	抑制単語	色々濃い
いろいろこうばしい	いろいろ香ばしい	抑制単語	色々香ばしい
いろいろこまかい	いろいろ細かい	抑制単語	色々細かい
いろいろこまかい	いろいろ細かい	抑制単語	色々細かい
いろいろこまかく	いろいろ細かく	抑制単語	色々細かく
いろいろこむずかしい	いろいろ小難しい	抑制単語	色々小難しい
いろいろこわ	いろいろ怖	抑制単語	色々怖
いろいろこわい	いろいろ怖い	抑制単語	色々怖い
いろいろこわかっ	いろいろ怖かっ	抑制単語	色々怖かっ
いろいろこわく	いろいろ怖く	抑制単語	色々怖く
いろいろさ	いろいろ差	抑制単語	色々差
いろいろさく	いろいろ策	抑制単語	色々策
いろいろさわがしい	いろいろ騒がしい	抑制単語	色々騒がしい
いろいろしゅ	いろいろ手	抑制単語	色々手
いろいろじん	いろいろ人	抑制単語	色々人
いろいろすばらしい	いろいろ素晴らしい	抑制単語	色々素晴らしい
いろいろせつ	いろいろ説	抑制単語	色々説
いろいろせつない	いろいろ切ない	抑制単語	色々切ない
いろいろせわしく	いろいろ忙しく	抑制単語	色々忙しく
いろいろたかい	いろいろ高い	抑制単語	色々高い
いろいろたかく	いろいろ高く	抑制単語	色々高く
いろいろたのし	いろいろ楽し	抑制単語	色々楽し
いろいろたのしい	いろいろ楽しい	抑制単語	色々楽しい
いろいろたのしい	いろいろ楽しい	抑制単語	色々楽しい
いろいろたのしかっ	いろいろ楽しかっ	抑制単語	色々楽しかっ
いろいろたのしかっ	いろいろ楽しかっ	抑制単語	色々楽しかっ
いろいろたのしく	いろいろ楽しく	抑制単語	色々楽しく
いろいろちいさい	いろいろ小さい	抑制単語	色々小さい
いろいろちかい	いろいろ近い	抑制単語	色々近い
いろいろちょう	いろいろ調	抑制単語	色々調
いろいろつよい	いろいろ強い	抑制単語	色々強い
いろいろつよく	いろいろ強く	抑制単語	色々強く
いろいろつらい	いろいろ辛い	抑制単語	色々辛い
いろいろつらかっ	いろいろ辛かっ	抑制単語	色々辛かっ
いろいろてびろく	いろいろ手広く	抑制単語	色々手広く
いろいろてん	いろいろ店	抑制単語	色々店
いろいろない	いろいろ無い	抑制単語	色々無い
いろいろながい	いろいろ長い	抑制単語	色々長い
いろいろながく	いろいろ長く	抑制単語	色々長く
いろいろなつかし	いろいろ懐かし	抑制単語	色々懐かし
いろいろなつかしい	いろいろ懐かしい	抑制単語	色々懐かしい
いろいろなつかしかっ	いろいろ懐かしかっ	抑制単語	色々懐かしかっ
いろいろなつかしく	いろいろ懐かしく	抑制単語	色々懐かしく
いろいろなやましい	いろいろ悩ましい	抑制単語	色々悩ましい
いろいろはずかしい	いろいろ恥ずかしい	抑制単語	色々恥ずかしい
いろいろはばひろい	いろいろ幅広い	抑制単語	色々幅広い
いろいろはばひろく	いろいろ幅広く	抑制単語	色々幅広く
いろいろはやい	いろいろ早い	抑制単語	色々早い
いろいろはやく	いろいろ早く	抑制単語	色々早く
いろいろばなし	いろいろ話	抑制単語	色々話
いろいろひど	いろいろ酷	抑制単語	色々酷
いろいろひどい	いろいろ酷い	抑制単語	色々酷い
いろいろひどかっ	いろいろ酷かっ	抑制単語	色々酷かっ
いろいろひどく	いろいろ酷く	抑制単語	色々酷く
いろいろひろく	いろいろ広く	抑制単語	色々広く
いろいろふか	いろいろ深	抑制単語	色々深
いろいろふかい	いろいろ深い	抑制単語	色々深い
いろいろふかく	いろいろ深く	抑制単語	色々深く
いろいろふるい	いろいろ古い	抑制単語	色々古い
いろいろほしい	いろいろ欲しい	抑制単語	色々欲しい
いろいろほしい	いろいろ欲しい	抑制単語	色々欲しい
いろいろほしかっ	いろいろ欲しかっ	抑制単語	色々欲しかっ
いろいろほしく	いろいろ欲しく	抑制単語	色々欲しく
いろいろまずい	いろいろ不味い	抑制単語	色々不味い
いろいろみぐるしい	いろいろ見苦しい	抑制単語	色々見苦しい
いろいろむごい	いろいろ酷い	抑制単語	色々酷い
いろいろむずかし	いろいろ難し	抑制単語	色々難し
いろいろむずかしい	いろいろ難しい	抑制単語	色々難しい
いろいろむずかしい	いろいろ難しい	抑制単語	色々難しい
いろいろむずかしかっ	いろいろ難しかっ	抑制単語	色々難しかっ
いろいろむずかしく	いろいろ難しく	抑制単語	色々難しく
いろいろむつかしい	いろいろ難しい	抑制単語	色々難しい
いろいろめ	いろいろ目	抑制単語	色々目
いろいろめずらしい	いろいろ珍しい	抑制単語	色々珍しい
いろいろめんどうくさい	いろいろ面倒くさい	抑制単語	色々面倒くさい
いろいろめんどうくさい	いろいろ面倒くさい	抑制単語	色々面倒臭い
いろいろめんどくさい	いろいろ面倒くさい	抑制単語	色々面倒くさい
いろいろめんどくさい	いろいろ面倒くさい	抑制単語	色々面倒臭い
いろいろものたりない	いろいろ物足りない	抑制単語	色々物足りない
いろいろやく	いろいろ訳	抑制単語	色々訳
いろいろやさしく	いろいろ優しく	抑制単語	色々優しく
いろいろやすい	いろいろ安い	抑制単語	色々安い
いろいろやすかっ	いろいろ安かっ	抑制単語	色々安かっ
いろいろやすく	いろいろ安く	抑制単語	色々安く
いろいろゆるい	いろいろ緩い	抑制単語	色々緩い
いろいろよい	いろいろ良い	抑制単語	色々良い
いろいろよかっ	いろいろ良かっ	抑制単語	色々良かっ
いろいろよく	いろいろ良く	抑制単語	色々良く
いろいろよわい	いろいろ弱い	抑制単語	色々弱い
いろいろわかい	いろいろ若い	抑制単語	色々若い
いろいろわずらわしい	いろいろ煩わしい	抑制単語	色々煩わしい
いろいろわるい	いろいろ悪い	抑制単語	色々悪い
いろいろわるかっ	いろいろ悪かっ	抑制単語	色々悪かっ
いろいろわるく	いろいろ悪く	抑制単語	色々悪く
いろう	胃ろう	抑制単語	胃瘻
いろすごい	色すごい	抑制単語	色凄い
いろすごく	色すごく	抑制単語	色凄く
いろつや	色つや	抑制単語	色艶
いろどりあふれる	彩りあふれる	抑制単語	彩り溢れる
いろはげ	色はげ	抑制単語	色剥げ
いわくつき	いわく付き	抑制単語	曰く付き
いわしぐも	いわし雲	抑制単語	鰯雲
いわつつじ	岩つつじ	抑制単語	岩躑躅
いわのり	岩のり	抑制単語	岩海苔
いんうつ	陰うつ	抑制単語	陰鬱
いんせき	いん石	抑制単語	隕石
いんとん	隠とん	抑制単語	隠遁
いんぺい	隠ぺい	抑制単語	隠蔽
いんぺいりょく	隠ぺい力	抑制単語	隠蔽力
いんろう	印ろう	抑制単語	印篭
いんろう	印ろう	抑制単語	印籠
うかい	う回	抑制単語	迂回
うかがいしる	うかがい知る	抑制単語	窺い知る
うかがいしれ	うかがい知れ	抑制単語	窺い知れ
うかがいしれ	うかがい知れ	抑制単語	窺い知れ
うかがいしれ	うかがい知れ	抑制単語	窺い知れ
うかがいしれよ	うかがい知れよ	抑制単語	窺い知れよ
うかがいしれる	うかがい知れる	抑制単語	窺い知れる
うかがいみる	うかがい見る	抑制単語	窺い見る
うきょく	う曲	抑制単語	迂曲
うぐいすいろ	うぐいす色	抑制単語	鴬色
うぐいすいろ	うぐいす色	抑制単語	鶯色
うけねらい	受けねらい	抑制単語	受け狙い
うごきにつながっ	動きにつながっ	抑制単語	動きに繋がっ
うごきにつながる	動きにつながる	抑制単語	動きに繋がる
うごきまわっ	動きまわっ	抑制単語	動き廻っ
うごきまわり	動きまわり	抑制単語	動き廻り
うごきまわる	動きまわる	抑制単語	動き廻る
うさんくさ	うさん臭	抑制単語	胡散臭
うさんくさい	うさん臭い	抑制単語	胡散臭い
うさんくさかっ	うさん臭かっ	抑制単語	胡散臭かっ
うさんくさく	うさん臭く	抑制単語	胡散臭く
うさんくささ	うさん臭さ	抑制単語	胡散臭さ
うさんくさそう	うさん臭そう	抑制単語	胡散臭そう
うしろだて	後ろだて	抑制単語	後ろ楯
うしろだて	後ろだて	抑制単語	後楯
うじむし	うじ虫	抑制単語	蛆虫
うすくちしょうゆ	薄口しょうゆ	抑制単語	薄口醤油
うずめ	うず目	抑制単語	烏頭目
うそはっぴゃく	うそ八百	抑制単語	嘘八百
うたいつが	うたい継が	抑制単語	唄い継が
うたいつない	歌いつない	抑制単語	歌い繋い
うたいつなぐ	歌いつなぐ	抑制単語	歌い繋ぐ
うたいもんく	うたい文句	抑制単語	謳い文句
うたうたい	歌うたい	抑制単語	歌唄い
うたまくら	歌まくら	抑制単語	歌枕
うちがま	内がま	抑制単語	内釜
うちきりくらっ	打ち切りくらっ	抑制単語	打ち切り喰らっ
うちくるぶし	内くるぶし	抑制単語	内踝
うちこみはぎ	打ち込みはぎ	抑制単語	打込み矧ぎ
うちこわし	打ちこわし	抑制単語	打ち毀し
うちこわし	打ち壊し	抑制単語	打毀し
うちたたい	打ちたたい	抑制単語	打ち叩い
うちたたく	打ちたたく	抑制単語	打ち叩く
うちでのこずち	打ち出の小づち	抑制単語	打出の小槌
うちでのこずち	打ち出の小づち	抑制単語	打出小槌
うちでのこづち	打ち出の小づち	抑制単語	打出の小槌
うちでのこづち	打ち出の小づち	抑制単語	打出小槌
うちなべ	内なべ	抑制単語	内鍋
うちのし	内のし	抑制単語	内熨斗
うちひしがれ	打ちひしがれ	抑制単語	打ち拉がれ
うちひしがれる	打ちひしがれる	抑制単語	打ち拉がれる
うちまた	内また	抑制単語	内股
うちもも	内もも	抑制単語	内腿
うちもらし	撃ちもらし	抑制単語	撃ち洩らし
うちわもめ	内輪もめ	抑制単語	内輪揉め
うっくつ	うっ屈	抑制単語	鬱屈
うっけつ	うっ血	抑制単語	鬱血
うっせき	うっ積	抑制単語	鬱積
うっぷん	うっ憤	抑制単語	鬱憤
うっぷんはらし	うっぷん晴らし	抑制単語	鬱憤晴らし
うっぷんをはらし	うっぷんを晴らし	抑制単語	鬱憤を晴らし
うっぷんをはらす	うっぷんを晴らす	抑制単語	鬱憤を晴らす
うつじょうたい	うつ状態	抑制単語	鬱状態
うつびょう	うつ病	抑制単語	鬱病
うつむい	うつ向い	抑制単語	俯向い
うつむきかげん	うつむき加減	抑制単語	俯き加減
うつむきかげん	うつ向き加減	抑制単語	俯き加減
うどんこ	うどん粉	抑制単語	饂飩粉
うなぎたべ	うなぎ食べ	抑制単語	鰻食べ
うなぎのぼり	うなぎ上り	抑制単語	鰻上り
うなじゅう	うな重	抑制単語	鰻重
うなずきかえし	うなずき返し	抑制単語	頷き返し
うなずきかえす	うなずき返す	抑制単語	頷き返す
うなりこえをあげ	うなり声を上げ	抑制単語	唸り声を上げ
うなりこえをあげる	うなり声を上げる	抑制単語	唸り声を上げる
うのはな	うの花	抑制単語	卯の花
うのはな	うの花	抑制単語	卯花
うばざくら	うば桜	抑制単語	姥桜
うみだし	うみ出し	抑制単語	膿み出し
うらごし	裏ごし	抑制単語	裏漉し
うらぶた	裏ぶた	抑制単語	裏蓋
うらぼん	うら盆	抑制単語	盂蘭盆
うりあげにつながっ	売り上げにつながっ	抑制単語	売り上げに繋がっ
うりあげにつながら	売り上げにつながら	抑制単語	売り上げに繋がら
うりあげにつながる	売り上げにつながる	抑制単語	売り上げに繋がる
うりさばい	売りさばい	抑制単語	売り捌い
うりさばか	売りさばか	抑制単語	売り捌か
うりさばき	売りさばき	抑制単語	売り捌き
うりさばく	売りさばく	抑制単語	売り捌く
うりさばけ	売りさばけ	抑制単語	売り捌け
うりさばけ	売りさばけ	抑制単語	売り捌け
うりさばけ	売りさばけ	抑制単語	売り捌け
うりさばける	売りさばける	抑制単語	売り捌ける
うりさばこ	売りさばこ	抑制単語	売り捌こ
うりさばこう	売りさばこう	抑制単語	売り捌こう
うりざねがお	うりざね顔	抑制単語	瓜実顔
うるうどし	うるう年	抑制単語	閏年
うるおいあふれる	潤いあふれる	抑制単語	潤い溢れる
うるちまい	うるち米	抑制単語	粳米
うれしいおしらせ	うれしいお知らせ	抑制単語	嬉しいお知らせ
うれしいきのう	うれしい機能	抑制単語	嬉しい機能
うれしいきもち	うれしい気持ち	抑制単語	嬉しい気持ち
うれしいこうか	うれしい効果	抑制単語	嬉しい効果
うれしいこうつう	うれしい交通	抑制単語	嬉しい交通
うれしいこえ	うれしい声	抑制単語	嬉しい声
うれしいことば	うれしい言葉	抑制単語	嬉しい言葉
うれしいごさん	うれしい誤算	抑制単語	嬉しい誤算
うれしいじょうほう	うれしい情報	抑制単語	嬉しい情報
うれしいせつび	うれしい設備	抑制単語	嬉しい設備
うれしいちょうしょく	うれしい朝食	抑制単語	嬉しい朝食
うれしいできごと	うれしい出来事	抑制単語	嬉しい出来事
うれしいとくてん	うれしい特典	抑制単語	嬉しい特典
うれしいひめい	うれしい悲鳴	抑制単語	嬉しい悲鳴
うれしいほうこく	うれしい報告	抑制単語	嬉しい報告
うれしなき	うれし泣き	抑制単語	嬉し泣き
うわぐすり	うわ薬	抑制単語	釉薬
うわごと	うわ言	抑制単語	譫言
うわさどおり	うわさ通り	抑制単語	噂通り
うわさどおり	うわさ通り	抑制単語	噂通り
えいこう	えい航	抑制単語	曳航
えいじ	えい児	抑制単語	嬰児
えがきがい	描きがい	抑制単語	描き甲斐
えがきため	描きため	抑制単語	描き溜め
えぐりださ	えぐり出さ	抑制単語	抉り出さ
えぐりだし	えぐり出し	抑制単語	抉り出し
えぐりだす	えぐり出す	抑制単語	抉り出す
えぐりとっ	えぐり取っ	抑制単語	抉り取っ
えぐりとら	えぐり取ら	抑制単語	抉り取ら
えぐりとり	えぐり取り	抑制単語	抉り取り
えぐりとる	えぐり取る	抑制単語	抉り取る
えっちゅうふんどし	越中ふんどし	抑制単語	越中褌
えびすがお	えびす顔	抑制単語	恵比須顔
えびすこう	えびす講	抑制単語	恵比須講
えびちゃ	えび茶	抑制単語	葡萄茶
えらびいただい	選びいただい	抑制単語	選び戴い
えらびいただき	選びいただき	抑制単語	選び戴き
えらびいただけ	選びいただけ	抑制単語	選び戴け
えらびいただける	選びいただける	抑制単語	選び戴ける
えらびがい	選びがい	抑制単語	選び甲斐
えりぐり	襟ぐり	抑制単語	襟刳り
えんか	えん下	抑制単語	嚥下
えんざい	えん罪	抑制単語	冤罪
えんじがい	演じがい	抑制単語	演じ甲斐
えんすい	円すい	抑制単語	円錐
えんせき	縁せき	抑制単語	縁戚
えんせん	えん戦	抑制単語	厭戦
えんばく	えん麦	抑制単語	燕麦
おいしいうなぎ	美味しいうなぎ	抑制単語	美味しい鰻
おいしいそば	美味しいそば	抑制単語	美味しい蕎麦
おいすがっ	追いすがっ	抑制単語	追い縋っ
おいすがり	追いすがり	抑制単語	追い縋り
おいすがる	追いすがる	抑制単語	追い縋る
おいすがろう	追いすがろう	抑制単語	追い縋ろう
おいはぎ	追いはぎ	抑制単語	追い剥ぎ
おいぼれ	老いぼれ	抑制単語	老い耄れ
おいまわし	追いまわし	抑制単語	追い廻し
おいまわし	追いまわし	抑制単語	追ひ廻し
おうか	おう歌	抑制単語	謳歌
おうが	横が	抑制単語	横臥
おうせい	おう盛	抑制単語	旺盛
おうだん	黄だん	抑制単語	黄疸
おうと	おう吐	抑制単語	嘔吐
おうとぶつ	おう吐物	抑制単語	嘔吐物
おうなつ	押なつ	抑制単語	押捺
おおあご	大あご	抑制単語	大顎
おおいちょう	大いちょう	抑制単語	大銀杏
おおうなぎ	大うなぎ	抑制単語	大鰻
おおくに	大くに	抑制単語	大國
おおぐちをたたく	大口をたたく	抑制単語	大口を叩く
おおけやき	大けやき	抑制単語	大欅
おおげさ	大げさ	抑制単語	大袈裟
おおげさ	大げさ	抑制単語	大袈裟
おおげさすぎ	大げさすぎ	抑制単語	大袈裟すぎ
おおさじ	大さじ	抑制単語	大匙
おおしま	大しま	抑制単語	大嶌
おおしまつむぎ	大島つむぎ	抑制単語	大島紬
おおずかみ	大づかみ	抑制単語	大掴み
おおつごもり	大つごもり	抑制単語	大晦
おおつごもり	大つごもり	抑制単語	大晦日
おおづかみ	大づかみ	抑制単語	大掴み
おおとら	大とら	抑制単語	大虎
おおとろ	大とろ	抑制単語	大瀞
おおなた	大なた	抑制単語	大鉈
おおなたをふるう	大なたを振るう	抑制単語	大鉈を振るう
おおなたをふるっ	大なたを振るっ	抑制単語	大鉈を振るっ
おおなべ	大なべ	抑制単語	大鍋
おおなまず	大なまず	抑制単語	大鯰
おおはし	大はし	抑制単語	大嘴
おおはし	大はし	抑制単語	大箸
おおぶろしき	大ぶろしき	抑制単語	大風呂敷
おおみそか	大みそか	抑制単語	大晦日
おおむこうをうならせる	大向こうをうならせる	抑制単語	大向こうを唸らせる
おおもうけ	大もうけ	抑制単語	大儲け
おかげさま	お陰様	抑制単語	御蔭様
おかねもうけ	お金もうけ	抑制単語	お金儲け
おかねもらえ	お金もらえ	抑制単語	お金貰え
おかめどう	おかめ堂	抑制単語	お亀堂
おくになまり	お国なまり	抑制単語	お国訛り
おくびょう	おく病	抑制単語	臆病
おくればせ	遅ればせ	抑制単語	遅れ馳せ
おけいこぎ	おけいこ着	抑制単語	お稽古着
おけいこごと	おけいこ事	抑制単語	お稽古事
おけいこよう	おけいこ用	抑制単語	お稽古用
おごってほしい	おごって欲しい	抑制単語	奢って欲しい
おごりたかぶっ	おごり高ぶっ	抑制単語	奢り高ぶっ
おごりたかぶっ	おごり高ぶっ	抑制単語	驕り高ぶっ
おごりたかぶら	おごり高ぶら	抑制単語	驕り高ぶら
おごりたかぶり	おごり高ぶり	抑制単語	驕り高ぶり
おごりたかぶる	おごり高ぶる	抑制単語	奢り高ぶる
おごりたかぶる	おごり高ぶる	抑制単語	驕り高ぶる
おさななじみ	幼なじみ	抑制単語	幼馴染
おさななじみ	幼なじみ	抑制単語	幼馴染み
おしえいただけれ	教えいただけれ	抑制単語	教え戴けれ
おしえがい	教えがい	抑制単語	教え甲斐
おしずし	押し寿司	抑制単語	押鮨
おしつぶさ	押しつぶさ	抑制単語	押し潰さ
おしつぶさん	押しつぶさん	抑制単語	押し潰さん
おしつぶし	押しつぶし	抑制単語	押し潰し
おしつぶす	押しつぶす	抑制単語	押し潰す
おしつぶせ	押しつぶせ	抑制単語	押し潰せ
おしつぶそ	押しつぶそ	抑制単語	押し潰そ
おしつぶそう	押しつぶそう	抑制単語	押し潰そう
おしつぶれ	押しつぶれ	抑制単語	押し潰れ
おしどりふうふ	おしどり夫婦	抑制単語	鴛鴦夫婦
おしべ	雄しべ	抑制単語	雄蕊
おしもみ	押しもみ	抑制単語	押し揉み
おしもむ	押しもむ	抑制単語	押し揉む
おしゃれかわいい	おしゃれ可愛い	抑制単語	お洒落可愛い
おしゃれかん	おしゃれ感	抑制単語	お洒落感
おしゃれぎ	おしゃれ着	抑制単語	お洒落着
おしゃれけい	おしゃれ系	抑制単語	お洒落系
おしゃれしん	おしゃれ心	抑制単語	お洒落心
おしゃれじょうきゅうしゃ	おしゃれ上級者	抑制単語	お洒落上級者
おしゃれど	おしゃれ度	抑制単語	お洒落度
おしょうゆ	おしょう油	抑制単語	お醤油
おしょうゆあじ	おしょうゆ味	抑制単語	お醤油味
おじぎそう	おじぎ草	抑制単語	含羞草
おすしや	おすし屋	抑制単語	お鮨屋
おすそわけ	おすそ分け	抑制単語	お裾分け
おぜんだて	おぜん立て	抑制単語	お膳立て
おぜんだて	おぜん立て	抑制単語	御膳立て
おそばや	おそば屋	抑制単語	お蕎麦屋
おそまき	遅まき	抑制単語	遅蒔き
おそれおののい	恐れおののい	抑制単語	恐れ慄い
おそれおののき	恐れおののき	抑制単語	恐れ慄き
おそれおののく	恐れおののく	抑制単語	恐れ慄く
おたまじゃくし	お玉じゃくし	抑制単語	お玉杓子
おちくぼみ	落ちくぼみ	抑制単語	落ち窪み
おちくぼん	落ちくぼん	抑制単語	落ち窪ん
おちぶれ	落ちぶれ	抑制単語	落魄れ
おちゃいれ	お茶いれ	抑制単語	お茶淹れ
おちゃわん	お茶わん	抑制単語	お茶碗
おてごろ	お手ごろ	抑制単語	お手頃
おてごろかん	お手ごろ感	抑制単語	お手頃感
おてすき	お手すき	抑制単語	お手隙
おてすき	お手透き	抑制単語	お手隙
おてふき	お手ふき	抑制単語	お手拭き
おとこだて	男だて	抑制単語	男伊達
おとさた	音さた	抑制単語	音沙汰
おとしぶた	落しぶた	抑制単語	落し蓋
おとしぶた	落としぶた	抑制単語	落し蓋
おとすごい	音すごい	抑制単語	音凄い
おとすごかっ	音すごかっ	抑制単語	音凄かっ
おとすごく	音すごく	抑制単語	音凄く
おどしにおびえ	脅しにおびえ	抑制単語	脅しに怯え
おどろきあきれ	驚きあきれ	抑制単語	驚き呆れ
おどろきあきれる	驚きあきれる	抑制単語	驚き呆れる
おどろきあふれる	驚きあふれる	抑制単語	驚き溢れる
おどろきにあふれ	驚きにあふれ	抑制単語	驚きに溢れ
おにあざみ	鬼あざみ	抑制単語	鬼薊
おにがわら	鬼がわら	抑制単語	鬼瓦
おねえさんかた	おねえさん方	抑制単語	お姐さん方
おねえさんたち	おねえさん達	抑制単語	お姐さん達
おのおのじぶん	おのおの自分	抑制単語	各々自分
おひざもと	おひざ元	抑制単語	お膝元
おひまつぶし	お暇つぶし	抑制単語	お暇潰し
おひれ	尾ひれ	抑制単語	尾鰭
おびただしいかず	おびただしい数	抑制単語	夥しい数
おびな	男びな	抑制単語	男雛
おびれ	尾びれ	抑制単語	尾鰭
おふろよう	おふろ用	抑制単語	お風呂用
おぼれしに	おぼれ死に	抑制単語	溺れ死に
おぼれしぬ	おぼれ死ぬ	抑制単語	溺れ死ぬ
おぼれしん	おぼれ死ん	抑制単語	溺れ死ん
おぼれじに	おぼれ死に	抑制単語	溺れ死に
おぼれじぬ	おぼれ死ぬ	抑制単語	溺れ死ぬ
おぼれじん	おぼれ死ん	抑制単語	溺れ死ん
おぼろこぶ	おぼろ昆布	抑制単語	朧昆布
おぼろずき	おぼろ月	抑制単語	朧月
おぼろずきよ	おぼろ月夜	抑制単語	朧月夜
おぼろづき	おぼろ月	抑制単語	朧月
おぼろづきよ	おぼろ月夜	抑制単語	朧月夜
おまんじゅうや	おまんじゅう屋	抑制単語	お饅頭屋
おみそしる	おみそ汁	抑制単語	お味噌汁
おもいあきらめ	思いあきらめ	抑制単語	思い諦め
おもいあきらめる	思いあきらめる	抑制単語	思い諦める
おもいあぐね	思いあぐね	抑制単語	思い倦ね
おもいあふれ	思いあふれ	抑制単語	思い溢れ
おもいあふれ	想いあふれ	抑制単語	想い溢れ
おもいあふれる	思いあふれる	抑制単語	思い溢れる
おもいあふれる	想いあふれる	抑制単語	想い溢れる
おもいきい	思いきい	抑制単語	思い訊い
おもいたずね	思いたずね	抑制単語	思い訊ね
おもいたどりつい	思いたどり着い	抑制単語	思い辿り着い
おもいためらっ	思いためらっ	抑制単語	思い躊躇っ
おもいつづっ	思いつづっ	抑制単語	思い綴っ
おもいつづる	思いつづる	抑制単語	思い綴る
おもいであっ	思い出あっ	抑制単語	想い出逢っ
おもいにあふれ	思いにあふれ	抑制単語	思いに溢れ
おもいにあふれ	想いにあふれ	抑制単語	想いに溢れ
おもいにさいなま	思いにさいなま	抑制単語	思いに苛ま
おもいにふけっ	思いにふけっ	抑制単語	思いに耽っ
おもいにふけっ	思いにふけっ	抑制単語	思いに耽っ
おもいにふけっ	想いにふけっ	抑制単語	想いに耽っ
おもいにふけり	思いにふけり	抑制単語	思いに耽り
おもいにふける	思いにふける	抑制単語	思いに耽る
おもいにふける	想いにふける	抑制単語	想いに耽る
おもいのぞい	思いのぞい	抑制単語	思い覗い
おもいはせる	想いはせる	抑制単語	想い馳せる
おもいふけっ	思いふけっ	抑制単語	思い耽っ
おもいやりあふれ	思いやりあふれ	抑制単語	思いやり溢れ
おもいやりあふれる	思いやりあふれる	抑制単語	思いやり溢れる
おもいやりにあふれ	思いやりにあふれ	抑制単語	思いやりに溢れ
おもうつぼ	思うつぼ	抑制単語	思う壷
おもうつぼ	思うつぼ	抑制単語	思う壺
おもうつぼにはまっ	思うつぼにはまっ	抑制単語	思う壺にはまっ
おもちゃばこ	おもちゃ箱	抑制単語	玩具箱
おもちゃや	おもちゃ屋	抑制単語	玩具屋
おもてざた	表ざた	抑制単語	表沙汰
おもわずうれし	思わずうれし	抑制単語	思わず嬉し
おもわずうれしく	思わずうれしく	抑制単語	思わず嬉しく
おもわずすごい	思わずすごい	抑制単語	思わず凄い
おやのすねをかじっ	親のすねをかじっ	抑制単語	親の脛をかじっ
おやのすねをかじっ	親のすねをかじっ	抑制単語	親の脛を齧っ
おやのすねをかじり	親のすねをかじり	抑制単語	親の脛をかじり
おやのすねをかじる	親のすねをかじる	抑制単語	親の脛をかじる
おやばか	親ばか	抑制単語	親馬鹿
おゆのみ	お湯のみ	抑制単語	お湯呑
おゆのみ	お湯のみ	抑制単語	お湯呑み
おゆのみ	お湯飲み	抑制単語	お湯呑
おりーぶせっけん	オリーブ石けん	抑制単語	オリーブ石鹸
おれいぶたいあいさつ	御礼舞台あいさつ	抑制単語	御礼舞台挨拶
おれにつながる	折れにつながる	抑制単語	折れに繋がる
おわびもうしあげ	おわび申し上げ	抑制単語	お詫び申し上げ
おんせんまんじゅう	温泉まんじゅう	抑制単語	温泉饅頭
おんなたらし	女たらし	抑制単語	女誑し
おんをあだでかえさ	恩をあだで返さ	抑制単語	恩を仇で返さ
おんをあだでかえし	恩をあだで返し	抑制単語	恩を仇で返し
おんをあだでかえす	恩をあだで返す	抑制単語	恩を仇で返す
かいあおり	買いあおり	抑制単語	買い煽り
かいあげいただい	買い上げいただい	抑制単語	買い上げ戴い
かいあげいただき	買い上げいただき	抑制単語	買い上げ戴き
かいいぬにてをかまれ	飼い犬に手をかまれ	抑制単語	飼い犬に手を噛まれ
かいいぬにてをかまれる	飼い犬に手をかまれる	抑制単語	飼い犬に手を噛まれる
かいくぐっ	かい潜っ	抑制単語	掻い潜っ
かいくぐり	かい潜り	抑制単語	掻い潜り
かいくぐる	かい潜る	抑制単語	掻い潜る
かいさく	開さく	抑制単語	開鑿
かいざん	改ざん	抑制単語	改竄
かいしょ	かい書	抑制単語	楷書
かいしょう	かい性	抑制単語	甲斐性
かいそう	回そう	抑制単語	回漕
かいそろえ	買いそろえ	抑制単語	買い揃え
かいそろえる	買いそろえる	抑制単語	買い揃える
かいたたい	買いたたい	抑制単語	買い叩い
かいたたか	買いたたか	抑制単語	買い叩か
かいたたき	買いたたき	抑制単語	買い叩き
かいたたく	買いたたく	抑制単語	買い叩く
かいたたける	買いたたける	抑制単語	買い叩ける
かいたたこ	買いたたこ	抑制単語	買い叩こ
かいたたこう	買いたたこう	抑制単語	買い叩こう
かいため	買いため	抑制単語	買い溜め
かいためる	買いためる	抑制単語	買い溜める
かいだし	かい出し	抑制単語	掻い出し
かいだめ	買いだめ	抑制単語	買い溜め
かいだめ	買いだめ	抑制単語	買溜め
かいだめ	買い貯め	抑制単語	買溜め
かいちょうあいさつ	会長あいさつ	抑制単語	会長挨拶
かいつまま	かい摘ま	抑制単語	掻い摘ま
かいつままん	かい摘まん	抑制単語	掻い摘まん
かいつまん	かい摘ん	抑制単語	掻い摘ん
かいならさ	飼いならさ	抑制単語	飼い馴らさ
かいならし	飼いならし	抑制単語	飼い馴らし
かいならす	飼いならす	抑制単語	飼い馴らす
かいならせ	飼いならせ	抑制単語	飼い馴らせ
かいびゃく	開びゃく	抑制単語	開闢
かいまくり	買いまくり	抑制単語	買い捲り
かいまくる	買いまくる	抑制単語	買い捲る
かいものかご	買い物かご	抑制単語	買い物籠
かいものかご	買物かご	抑制単語	買い物籠
かいらん	解らん	抑制単語	解纜
かいり	かい離	抑制単語	乖離
かいわい	界わい	抑制単語	界隈
かおいろをうかがう	顔色をうかがう	抑制単語	顔色を窺う
かおいろをうかがっ	顔色をうかがっ	抑制単語	顔色を窺っ
かおかたち	顔かたち	抑制単語	顔貌
かおかゆい	顔かゆい	抑制単語	顔痒い
かおすごい	顔すごい	抑制単語	顔凄い
かおすごく	顔すごく	抑制単語	顔凄く
かおそり	顔そり	抑制単語	顔剃り
かおつなぎ	顔つなぎ	抑制単語	顔繋ぎ
かおなじみ	顔なじみ	抑制単語	顔馴染
かおなじみ	顔なじみ	抑制単語	顔馴染み
かおやせ	顔やせ	抑制単語	顔痩せ
かおりあふれる	薫りあふれる	抑制単語	薫り溢れる
かおりあふれる	香りあふれる	抑制単語	香り溢れる
かおりにあふれ	香りにあふれ	抑制単語	香りに溢れ
かおりにひか	香りにひか	抑制単語	香りに惹か
かおをしかめ	顔をしかめ	抑制単語	顔を顰め
かおをしかめる	顔をしかめる	抑制単語	顔を顰める
かかとおとし	かかと落とし	抑制単語	踵落とし
かかとぶ	かかと部	抑制単語	踵部
かかとぶぶん	かかと部分	抑制単語	踵部分
かがみもち	鏡もち	抑制単語	鏡餅
かがやきあふれる	輝きあふれる	抑制単語	輝き溢れる
かがやきかがやき	輝きかがやき	抑制単語	輝き煌き
かがやきにあふれ	輝きにあふれ	抑制単語	輝きに溢れ
かがりび	かがり火	抑制単語	篝火
かき	花き	抑制単語	花卉
かきあげ	かき揚げ	抑制単語	掻き揚げ
かきあげ	かき揚げ	抑制単語	掻揚げ
かきあげ	かき揚げ	抑制単語	搔き揚げ
かきあげ	かき揚げ	抑制単語	掻き揚げ
かきあげ	かき揚げ	抑制単語	掻き揚げ
かきあげ	かき上げ	抑制単語	掻き上げ
かきあげ	かき上げ	抑制単語	掻き上げ
かきあげる	かき上げる	抑制単語	掻き上げる
かきあつめ	かき集め	抑制単語	掻き集め
かきあつめ	かき集め	抑制単語	掻き集め
かきあつめよ	かき集めよ	抑制単語	掻き集めよ
かきあつめる	かき集める	抑制単語	掻き集める
かきあて	下記あて	抑制単語	下記宛て
かきあわせ	かき合わせ	抑制単語	掻き合わせ
かきいだき	かき抱き	抑制単語	掻き抱き
かきいれ	かき入れ	抑制単語	掻き入れ
かきおこし	かき起こし	抑制単語	掻き起こし
かきおとし	かき落とし	抑制単語	掻き落し
かきおとし	かき落とし	抑制単語	掻き落とし
かきおとし	かき落とし	抑制単語	搔き落とし
かきおとし	書き落とし	抑制単語	掻き落し
かきおとす	かき落とす	抑制単語	掻き落す
かきおとす	かき落とす	抑制単語	掻き落とす
かきおとす	書き落とす	抑制単語	掻き落す
かきおろし	かき下ろし	抑制単語	掻き下ろし
かきがい	描きがい	抑制単語	描き甲斐
かきがい	書きがい	抑制単語	書き甲斐
かききえ	かき消え	抑制単語	掻き消え
かききえる	かき消える	抑制単語	掻き消える
かききず	かき傷	抑制単語	掻き傷
かききら	かき切ら	抑制単語	掻き切ら
かきくもり	かき曇り	抑制単語	掻き曇り
かきけさ	かき消さ	抑制単語	掻き消さ
かきけし	かき消し	抑制単語	掻き消し
かきけす	かき消す	抑制単語	掻き消す
かきけせる	かき消せる	抑制単語	掻き消せる
かきけそ	かき消そ	抑制単語	掻き消そ
かきこみ	かき込み	抑制単語	掻き込み
かきこむ	かき込む	抑制単語	掻き込む
かきこめる	かき込める	抑制単語	掻き込める
かきこや	かき小屋	抑制単語	牡蠣小屋
かきこわさ	かき壊さ	抑制単語	掻き壊さ
かきこわし	かき壊し	抑制単語	掻き壊し
かきこわし	かき壊し	抑制単語	搔き壊し
かきこわす	かき壊す	抑制単語	掻き壊す
かきこん	かき込ん	抑制単語	掻き込ん
かきすて	かき捨て	抑制単語	掻き捨て
かきたた	かき立た	抑制単語	掻き立た
かきたて	かき立て	抑制単語	掻き立て
かきたて	かき立て	抑制単語	掻き立て
かきたてよ	かき立てよ	抑制単語	掻き立てよ
かきたてる	かき立てる	抑制単語	掻き立てる
かきたまご	かき卵	抑制単語	掻き卵
かきため	描きため	抑制単語	描き溜め
かきため	書きため	抑制単語	書き溜め
かきため	書きため	抑制単語	書き溜め
かきためる	書きためる	抑制単語	書き溜める
かきださ	かき出さ	抑制単語	掻き出さ
かきだし	かき出し	抑制単語	掻き出し
かきだし	かき出し	抑制単語	搔き出し
かきだす	かき出す	抑制単語	掻き出す
かきだす	かき出す	抑制単語	搔き出す
かきだせ	かき出せ	抑制単語	掻き出せ
かきだせ	かき出せ	抑制単語	掻き出せ
かきだせる	かき出せる	抑制単語	掻き出せる
かきだそ	かき出そ	抑制単語	掻き出そ
かきつずっ	書きつづっ	抑制単語	書き綴っ
かきつずら	書きつづら	抑制単語	書き綴ら
かきつずり	書きつづり	抑制単語	書き綴り
かきつずる	書きつづる	抑制単語	書き綴る
かきつづっ	書きつづっ	抑制単語	書き綴っ
かきつづら	書きつづら	抑制単語	書き綴ら
かきつづり	書きつづり	抑制単語	書き綴り
かきつづる	書きつづる	抑制単語	書き綴る
かきつぶし	書きつぶし	抑制単語	書き潰し
かきとっ	かき取っ	抑制単語	掻き取っ
かきとり	かき取り	抑制単語	掻き取り
かきとる	かき取る	抑制単語	掻き取る
かきならさ	かき鳴らさ	抑制単語	掻き鳴らさ
かきならし	かき鳴らし	抑制単語	掻き鳴らし
かきならす	かき鳴らす	抑制単語	掻き鳴らす
かきならせ	かき鳴らせ	抑制単語	掻き鳴らせ
かきなれ	書きなれ	抑制単語	書き馴れ
かきぼう	かき棒	抑制単語	掻き棒
かきぼう	かき棒	抑制単語	舁き棒
かきまぜ	かき混ぜ	抑制単語	掻き混ぜ
かきまぜ	かき混ぜ	抑制単語	掻き混ぜ
かきまぜる	かき混ぜる	抑制単語	掻き混ぜる
かきまわさ	かき回さ	抑制単語	掻き回さ
かきまわし	かき回し	抑制単語	掻き回し
かきまわす	かき回す	抑制単語	掻き回す
かきまわせ	かき回せ	抑制単語	掻き回せ
かきまわせる	かき回せる	抑制単語	掻き回せる
かきみださ	かき乱さ	抑制単語	掻き乱さ
かきみだし	かき乱し	抑制単語	掻き乱し
かきみだす	かき乱す	抑制単語	掻き乱す
かきもらし	書きもらし	抑制単語	書き洩らし
かきもれ	書きもれ	抑制単語	書き洩れ
かきよせ	かき寄せ	抑制単語	掻き寄せ
かきよせる	かき寄せる	抑制単語	掻き寄せる
かきわけ	かき分け	抑制単語	掻き分け
かきわけ	かき分け	抑制単語	掻き分け
かきわけ	かき分け	抑制単語	搔き分け
かきわけかきわけ	かき分けかき分け	抑制単語	掻き分け掻き分け
かきわけすすむ	かき分け進む	抑制単語	掻き分け進む
かきわける	かき分ける	抑制単語	掻き分ける
かぎあみ	かぎ編み	抑制単語	鍵編み
かぎだす	かぎ出す	抑制単語	嗅ぎ出す
かぎっこ	かぎっ子	抑制単語	鍵っ子
かぎつき	カギ付き	抑制単語	鍵付
かぎとり	かぎ取り	抑制単語	嗅ぎ取り
かぎわけ	かぎ分け	抑制単語	嗅ぎ分け
かぎわけ	かぎ分け	抑制単語	嗅ぎ分け
かぎわける	かぎ分ける	抑制単語	嗅ぎ分ける
かくおおさじ	各大さじ	抑制単語	各大匙
かくざ	かく座	抑制単語	擱座
かくしゅ	かく首	抑制単語	馘首
かくしゅ	かく首	抑制単語	鶴首
かくしゅとりそろえ	各種取りそろえ	抑制単語	各種取り揃え
かくせい	覚せい	抑制単語	覚醒
かくはんき	かくはん機	抑制単語	撹拌機
かくはんき	かくはん機	抑制単語	攪拌機
かくひれ	各ひれ	抑制単語	各鰭
かくらん	かく乱	抑制単語	撹乱
かくらん	かく乱	抑制単語	攪乱
かくれみの	隠れみの	抑制単語	隠れ蓑
かけあし	かけ足	抑制単語	駈け足
かけおち	かけ落ち	抑制単語	駈け落ち
かけおち	欠け落ち	抑制単語	駈落ち
かけおり	かけ降り	抑制単語	駈け降り
かけながし	かけ流し	抑制単語	賭け流し
かけぬけ	かけ抜け	抑制単語	翔け抜け
かけぬけ	かけ抜け	抑制単語	駈け抜け
かけぶとん	掛け布団	抑制単語	掛蒲団
かけぶとん	かけ布団	抑制単語	掛蒲団
かけよっ	かけ寄っ	抑制単語	駈け寄っ
かけより	かけ寄り	抑制単語	駈け寄り
かけよる	かけ寄る	抑制単語	駈け寄る
かげぐちをたたい	陰口をたたい	抑制単語	陰口を叩い
かげぐちをたたか	陰口をたたか	抑制単語	陰口を叩か
かげぐちをたたき	陰口をたたき	抑制単語	陰口を叩き
かげぐちをたたく	陰口をたたく	抑制単語	陰口を叩く
かこうがん	かこう岩	抑制単語	花崗岩
かこうでんぷん	加工でん粉	抑制単語	加工澱粉
かごのとり	かごの鳥	抑制単語	篭の鳥
かごのとり	かごの鳥	抑制単語	籠の鳥
かさたかい	かさ高い	抑制単語	嵩高い
かさたかく	かさ高く	抑制単語	嵩高く
かさたかさ	かさ高さ	抑制単語	嵩高さ
かさだかい	かさ高い	抑制単語	嵩高い
かさだかく	かさ高く	抑制単語	嵩高く
かさだかさ	かさ高さ	抑制単語	嵩高さ
かさばっ	かさ張っ	抑制単語	嵩張っ
かさばら	かさ張ら	抑制単語	嵩張ら
かさばり	かさ張り	抑制単語	嵩張り
かさばりがち	かさ張りがち	抑制単語	嵩張りがち
かさばる	かさ張る	抑制単語	嵩張る
かさまし	かさ増し	抑制単語	嵩増し
かさまし	かさ増し	抑制単語	嵩増し
かざりがい	飾りがい	抑制単語	飾り甲斐
かざりつるし	飾りつるし	抑制単語	飾り吊るし
かざりぼたん	飾りボタン	抑制単語	飾釦
かしはがし	貸しはがし	抑制単語	貸し剥がし
かしはがし	貸しはがし	抑制単語	貸し剥し
かじとり	かじ取り	抑制単語	舵取り
かじりあと	かじり跡	抑制単語	齧り跡
かじりき	かじり木	抑制単語	囓り木
かじりき	かじり木	抑制単語	齧り木
かじりくせ	かじり癖	抑制単語	齧り癖
かじりつい	かじり付い	抑制単語	齧り付い
かじりつき	かじり付き	抑制単語	齧り付き
かじりつく	かじり付く	抑制単語	齧り付く
かじりとっ	かじり取っ	抑制単語	齧り取っ
かじりとら	かじり取ら	抑制単語	齧り取ら
かすじる	かす汁	抑制単語	粕汁
かすめとっ	かすめ取っ	抑制単語	掠め取っ
かすめとら	かすめ取ら	抑制単語	掠め取ら
かすめとり	かすめ取り	抑制単語	掠め取り
かすめとる	かすめ取る	抑制単語	掠め取る
かすめとろ	かすめ取ろ	抑制単語	掠め取ろ
かすりきず	かすり傷	抑制単語	掠り傷
かぞくだんらん	家族だんらん	抑制単語	家族団欒
かぞくだんらん	家族団らん	抑制単語	家族団欒
かたい	下たい	抑制単語	下腿
かたくりこ	かたくり粉	抑制単語	片栗粉
かたずをのん	かたずを飲ん	抑制単語	固唾を飲ん
かたにはまっ	型にはまっ	抑制単語	型に嵌まっ
かたにはめ	型にはめ	抑制単語	型に嵌め
かたにはめ	型にはめ	抑制単語	型に嵌め
かたにはめよ	型にはめよ	抑制単語	型に嵌めよ
かたにはめよう	型にはめよう	抑制単語	型に嵌めよう
かたにはめる	型にはめる	抑制単語	型に嵌める
かたひじ	片ひじ	抑制単語	片肘
かたひじ	肩ひじ	抑制単語	肩肘
かたひも	肩ひも	抑制単語	肩紐
かたまひ	片まひ	抑制単語	片麻痺
かためにゆで	固めにゆで	抑制単語	固めに茹で
かためにゆでる	固めにゆでる	抑制単語	固めに茹でる
かたもみ	肩もみ	抑制単語	肩揉み
かたをたたい	肩をたたい	抑制単語	肩を叩い
かたをたたか	肩をたたか	抑制単語	肩を叩か
かたをたたき	肩をたたき	抑制単語	肩を叩き
かたをたたく	肩をたたく	抑制単語	肩を叩く
かちどき	勝ちどき	抑制単語	勝ち鬨
かちどき	勝ちどき	抑制単語	勝鬨
かちにつながっ	勝ちにつながっ	抑制単語	勝ちに繋がっ
かちにつながる	勝ちにつながる	抑制単語	勝ちに繋がる
かっきっ	かっ切っ	抑制単語	掻っ切っ
かっきら	かっ切ら	抑制単語	掻っ切ら
かっきる	かっ切る	抑制単語	掻っ切る
かっこいい	格好いい	抑制単語	恰好良い
かっこういい	格好いい	抑制単語	恰好良い
かっこうよ	格好よ	抑制単語	恰好良
かっこうよい	格好よい	抑制単語	恰好良い
かっこうよかっ	格好よかっ	抑制単語	恰好良かっ
かっこうよく	格好よく	抑制単語	恰好良く
かっこうよさ	格好よさ	抑制単語	恰好良さ
かっこみ	かっ込み	抑制単語	掻っ込み
かっこむ	かっ込む	抑制単語	掻っ込む
かっこよ	格好よ	抑制単語	恰好良
かっこよい	格好よい	抑制単語	恰好良い
かっこよかっ	格好よかっ	抑制単語	恰好良かっ
かっこよく	格好よく	抑制単語	恰好良く
かっこよさ	格好よさ	抑制単語	恰好良さ
かっこわるい	かっこ悪い	抑制単語	恰好悪い
かっこわるく	かっこ悪く	抑制単語	恰好悪く
かっこん	かっ込ん	抑制単語	掻っ込ん
かっさい	喝さい	抑制単語	喝采
かっぽ	かっ歩	抑制単語	闊歩
かっぽう	割ぽう	抑制単語	割烹
かっぽうりょうり	かっぽう料理	抑制単語	割烹料理
かっぽうりょうり	割ぽう料理	抑制単語	割烹料理
かつおぶし	かつお節	抑制単語	鰹節
かつおぶしけずり	かつお節削り	抑制単語	鰹節削り
かつもく	かつ目	抑制単語	刮目
かなしみにあふれ	悲しみにあふれ	抑制単語	悲しみに溢れ
かなずち	金づち	抑制単語	金槌
かなづち	金づち	抑制単語	金槌
かならずすごい	必ずすごい	抑制単語	必ず凄い
かにりょうり	かに料理	抑制単語	蟹料理
かねずる	金づる	抑制単語	金蔓
かねそろえ	兼ねそろえ	抑制単語	兼ね揃え
かねそろえる	兼ねそろえる	抑制単語	兼ね揃える
かねづる	金づる	抑制単語	金蔓
かねもうけ	金もうけ	抑制単語	金儲け
かのう	か納	抑制単語	嘉納
かのう	化のう	抑制単語	化膿
かばやき	かば焼き	抑制単語	蒲焼
かばやき	かば焼き	抑制単語	蒲焼き
かばんや	かばん屋	抑制単語	鞄屋
かびくさい	かび臭い	抑制単語	黴臭い
かびくさく	かび臭く	抑制単語	黴臭く
かびくささ	かび臭さ	抑制単語	黴臭さ
かぶりつい	かぶり付い	抑制単語	齧り付い
かぶりつき	かぶり付き	抑制単語	齧り付き
かぶりつく	かぶり付く	抑制単語	齧り付く
かまくび	かま首	抑制単語	鎌首
かみあい	かみ合い	抑制単語	噛み合い
かみあいにくい	かみ合いにくい	抑制単語	噛み合いにくい
かみあう	かみ合う	抑制単語	噛み合う
かみあえ	かみ合え	抑制単語	噛み合え
かみあっ	かみ合っ	抑制単語	噛み合っ
かみあっていれば	かみ合っていれば	抑制単語	噛み合っていれば
かみあわ	かみ合わ	抑制単語	噛み合わ
かみあわ	かみ合わ	抑制単語	嚙み合わ
かみあわさっ	かみ合わさっ	抑制単語	噛み合わさっ
かみあわさり	かみ合わさり	抑制単語	噛み合わさり
かみあわせ	かみ合せ	抑制単語	咬み合せ
かみあわせない	かみ合わせない	抑制単語	噛み合わせない
かみあわなくなっ	かみ合わなくなっ	抑制単語	噛み合わなくなっ
かみあわなくなり	かみ合わなくなり	抑制単語	噛み合わなくなり
かみあわなくなる	かみ合わなくなる	抑制単語	噛み合わなくなる
かみあわん	かみ合わん	抑制単語	噛み合わん
かみがかり	神がかり	抑制単語	神憑り
かみきず	かみ傷	抑制単語	咬み傷
かみきず	かみ傷	抑制単語	噛み傷
かみきっ	かみ切っ	抑制単語	噛み切っ
かみきら	かみ切ら	抑制単語	噛み切ら
かみきり	かみ切り	抑制単語	噛み切り
かみきりやすく	かみ切りやすく	抑制単語	噛み切りやすく
かみきる	かみ切る	抑制単語	咬み切る
かみきる	かみ切る	抑制単語	噛み切る
かみくず	紙くず	抑制単語	紙屑
かみくせ	かみ癖	抑制単語	噛み癖
かみくだい	かみ砕い	抑制単語	噛み砕い
かみくだか	かみ砕か	抑制単語	噛み砕か
かみくだき	かみ砕き	抑制単語	噛み砕き
かみくだく	かみ砕く	抑制単語	咬み砕く
かみくだく	かみ砕く	抑制単語	噛み砕く
かみこたえ	かみ応え	抑制単語	噛み応え
かみこみ	かみ込み	抑制単語	咬み込み
かみこみ	かみ込み	抑制単語	噛み込み
かみころさ	かみ殺さ	抑制単語	咬み殺さ
かみころさ	かみ殺さ	抑制単語	噛み殺さ
かみころし	かみ殺し	抑制単語	咬み殺し
かみころし	かみ殺し	抑制単語	噛み殺し
かみころす	かみ殺す	抑制単語	咬み殺す
かみころす	かみ殺す	抑制単語	噛み殺す
かみごう	かみ合	抑制単語	噛み合
かみしめ	かみ締め	抑制単語	噛み締め
かみしめ	かみ締め	抑制単語	噛み締め
かみしめる	かみ締める	抑制単語	噛み締める
かみすき	紙すき	抑制単語	紙漉き
かみやすり	紙やすり	抑制単語	紙鑢
かみよう	かみ様	抑制単語	噛み様
かみをすい	髪をすい	抑制単語	髪を梳い
かみをすか	髪をすか	抑制単語	髪を梳か
かみをすき	髪をすき	抑制単語	髪を梳き
かみをすく	髪をすく	抑制単語	髪を梳く
かやぶきやね	かやぶき屋根	抑制単語	茅葺き屋根
かやぶきやね	かやぶき屋根	抑制単語	茅葺屋根
かゆいところにてがとどい	かゆいところに手が届い	抑制単語	痒いところに手が届い
かゆいところにてがとどい	かゆいところに手が届い	抑制単語	痒い所に手が届い
かゆいところにてがとどい	かゆい所に手が届い	抑制単語	痒い所に手が届い
かゆいところにてがとどか	かゆいところに手が届か	抑制単語	痒いところに手が届か
かゆいところにてがとどか	かゆいところに手が届か	抑制単語	痒い所に手が届か
かゆいところにてがとどか	かゆい所に手が届か	抑制単語	痒い所に手が届か
かゆいところにてがとどき	かゆいところに手が届き	抑制単語	痒いところに手が届き
かゆいところにてがとどき	かゆいところに手が届き	抑制単語	痒い所に手が届き
かゆいところにてがとどき	かゆい所に手が届き	抑制単語	痒い所に手が届き
かゆいところにてがとどく	かゆいところに手が届く	抑制単語	痒いところに手が届く
かゆいところにてがとどく	かゆいところに手が届く	抑制単語	痒い所に手が届く
かゆいところにてがとどく	かゆい所に手が届く	抑制単語	痒い所に手が届く
かゆみどめ	かゆみ止め	抑制単語	痒み止め
かよいなれ	通いなれ	抑制単語	通い馴れ
からしな	からし菜	抑制単語	芥子菜
からみそ	辛みそ	抑制単語	辛味噌
からみそらーめん	辛みそラーメン	抑制単語	辛味噌ラーメン
からめて	からめ手	抑制単語	搦手
からめとら	からめ捕ら	抑制単語	搦め捕ら
からめとる	からめ捕る	抑制単語	搦め捕る
かりそろえ	刈りそろえ	抑制単語	刈り揃え
かりそろえ	刈りそろえ	抑制単語	刈り揃え
かりそろえる	刈りそろえる	抑制単語	刈り揃える
かりひも	仮ひも	抑制単語	仮紐
かるくちをたたい	軽口をたたい	抑制単語	軽口を叩い
かるくちをたたき	軽口をたたき	抑制単語	軽口を叩き
かるくちをたたく	軽口をたたく	抑制単語	軽口を叩く
かれつ	か烈	抑制単語	苛烈
かわはぎ	皮はぎ	抑制単語	皮剥ぎ
かわひも	革ひも	抑制単語	革紐
かわむき	皮むき	抑制単語	皮剥き
かわむけ	皮むけ	抑制単語	皮剥け
かわらばん	かわら版	抑制単語	瓦版
かんおけ	棺おけ	抑制単語	棺桶
かんがん	肝がん	抑制単語	肝癌
かんきつけい	かんきつ系	抑制単語	柑橘系
かんきつるい	かんきつ類	抑制単語	柑橘類
かんげいこ	寒げいこ	抑制単語	寒稽古
かんげき	間げき	抑制単語	間隙
かんげん	かん言	抑制単語	諌言
かんげん	かん言	抑制単語	諫言
かんげんみずあめ	還元水あめ	抑制単語	還元水飴
かんこう	かん口	抑制単語	箝口
かんこう	かん口	抑制単語	緘口
かんこうれい	かん口令	抑制単語	箝口令
かんし	かん子	抑制単語	鉗子
かんしゃくだま	かんしゃく玉	抑制単語	癇癪玉
かんじになじん	感じになじん	抑制単語	感じに馴染ん
かんじにまとまっ	感じにまとまっ	抑制単語	感じに纏まっ
かんすい	かん水	抑制単語	潅水
かんすい	かん水	抑制単語	灌水
かんせん	乾せん	抑制単語	乾癬
かんぞうがん	肝臓がん	抑制単語	肝臓癌
かんちょう	かん腸	抑制単語	浣腸
かんにさわる	かんに障る	抑制単語	癇に障る
かんにゅう	かん入	抑制単語	嵌入
かんのうほう	肝のう胞	抑制単語	肝嚢胞
かんのむし	かんの虫	抑制単語	疳の虫
かんのむし	かんの虫	抑制単語	癇の虫
かんぴょう	干ぴょう	抑制単語	干瓢
かんぶり	寒ぶり	抑制単語	寒鰤
かんぺき	完ぺき	抑制単語	完璧
かんぺきしゅぎしゃ	完ぺき主義者	抑制単語	完璧主義者
かんぼく	かん木	抑制単語	潅木
かんぼく	かん木	抑制単語	灌木
かんめん	乾めん	抑制単語	乾麺
かんもく	かん黙	抑制単語	緘黙
かんよう	かん養	抑制単語	涵養
かんるいにむせぶ	感涙にむせぶ	抑制単語	感涙に咽ぶ
かんるいにむせん	感涙にむせん	抑制単語	感涙に咽ん
がいせん	がい旋	抑制単語	凱旋
がいとう	外とう	抑制単語	外套
がいぶひばく	外部被ばく	抑制単語	外部被曝
がかい	が解	抑制単語	瓦解
がくぜん	がく然	抑制単語	愕然
がけくずれ	がけ崩れ	抑制単語	崖崩れ
がしょう	が床	抑制単語	臥床
がびょう	画びょう	抑制単語	画鋲
がまぐち	がま口	抑制単語	蝦蟇口
がんかんじゃ	がん患者	抑制単語	癌患者
がんぐ	がん具	抑制単語	玩具
がんさいぼう	がん細胞	抑制単語	癌細胞
がんさく	がん作	抑制単語	贋作
がんそう	含そう	抑制単語	含嗽
がんちりょう	がん治療	抑制単語	癌治療
がんばりがい	頑張りがい	抑制単語	頑張り甲斐
きいちご	木いちご	抑制単語	木苺
きいてあきれ	聞いてあきれ	抑制単語	聞いて呆れ
きいてあきれる	聞いてあきれる	抑制単語	聞いて呆れる
きかいすき	機械すき	抑制単語	機械漉き
きかんしぜんそく	気管支ぜんそく	抑制単語	気管支喘息
きが	起が	抑制単語	起臥
きがとがめ	気がとがめ	抑制単語	気が咎め
きがとがめる	気がとがめる	抑制単語	気が咎める
ききいただけ	聴きいただけ	抑制単語	聴き戴け
ききかじっ	聞きかじっ	抑制単語	聞き齧っ
ききかじり	聞きかじり	抑制単語	聞き齧り
ききがい	聴きがい	抑制単語	聴き甲斐
ききとがめ	聞きとがめ	抑制単語	聞き咎め
ききなじみ	聞きなじみ	抑制単語	聞き馴染み
ききなじみ	聴きなじみ	抑制単語	聴き馴染み
ききなじん	聞きなじん	抑制単語	聞き馴染ん
ききなじん	聴きなじん	抑制単語	聴き馴染ん
ききなれ	聞きなれ	抑制単語	聞き馴れ
ききなれ	聞きなれ	抑制単語	聞き馴れ
ききなれ	聴きなれ	抑制単語	聴き馴れ
ききほれ	聞きほれ	抑制単語	聞き惚れ
ききほれ	聴きほれ	抑制単語	聴き惚れ
ききほれる	聞きほれる	抑制単語	聞き惚れる
ききほれる	聴きほれる	抑制単語	聴き惚れる
ききもらさ	聞きもらさ	抑制単語	聞き洩らさ
ききもらし	聞きもらし	抑制単語	聞き洩らし
ききもらす	聞きもらす	抑制単語	聞き洩らす
ききん	飢きん	抑制単語	飢饉
きく	危く	抑制単語	危懼
きくず	木くず	抑制単語	木屑
きぐ	危ぐ	抑制単語	危惧
きごう	揮ごう	抑制単語	揮毫
きざみのり	刻みのり	抑制単語	刻み海苔
きし	き死	抑制単語	愧死
きしょう	き傷	抑制単語	毀傷
きすう	帰すう	抑制単語	帰趨
きずあと	傷あと	抑制単語	傷痕
きずきにつながる	気づきにつながる	抑制単語	気づきに繋がる
きぜん	き然	抑制単語	毅然
きそん	き損	抑制単語	毀損
きたえがい	鍛えがい	抑制単語	鍛え甲斐
きたきりすずめ	着たきりすずめ	抑制単語	着た切り雀
きち	き知	抑制単語	窺知
きっこう	きっ抗	抑制単語	拮抗
きってほしい	きって欲しい	抑制単語	斬って欲しい
きつねのよめいり	きつねの嫁入り	抑制単語	狐の嫁入り
きつぶし	着つぶし	抑制単語	着潰し
きづかいあふれる	気遣いあふれる	抑制単語	気遣い溢れる
きづかいにあふれ	気遣いにあふれ	抑制単語	気遣いに溢れ
きづきにつながり	気づきにつながり	抑制単語	気づきに繋がり
きづきにつながる	気づきにつながる	抑制単語	気づきに繋がる
きとう	祈とう	抑制単語	祈祷
きとう	祈とう	抑制単語	祈禱
きぬごし	絹ごし	抑制単語	絹漉
きびすをかえし	きびすを返し	抑制単語	踵を返し
きびすをかえす	きびすを返す	抑制単語	踵を返す
きまま	気まま	抑制単語	気侭
きまま	気まま	抑制単語	気儘
きまま	気まま	抑制単語	気侭
きまま	気まま	抑制単語	気儘
きもいり	肝いり	抑制単語	肝煎
きもいり	肝いり	抑制単語	肝煎り
きもちすごく	気持ちすごく	抑制単語	気持ち凄く
きもと	生もと	抑制単語	生酛
きもをつぶし	肝をつぶし	抑制単語	肝を潰し
きゃくなめ	客なめ	抑制単語	客舐め
きゅうかく	きゅう覚	抑制単語	嗅覚
きゅうこうばい	急こう配	抑制単語	急勾配
きゅうしゃ	きゅう舎	抑制単語	厩舎
きゅうしゃ	きゅう舎	抑制単語	鳩舎
きゅうしゅん	急しゅん	抑制単語	急峻
きゅうばをしのい	急場をしのい	抑制単語	急場を凌い
きゅうばをしのぎ	急場をしのぎ	抑制単語	急場を凌ぎ
きゅうばをしのぐ	急場をしのぐ	抑制単語	急場を凌ぐ
きゅうばをしのごう	急場をしのごう	抑制単語	急場を凌ごう
きゅうりょうもらえ	給料もらえ	抑制単語	給料貰え
きょううれしい	今日うれしい	抑制単語	今日嬉しい
きょううれしかっ	今日うれしかっ	抑制単語	今日嬉しかっ
きょうがく	驚がく	抑制単語	驚愕
きょうく	恐く	抑制単語	恐懼
きょうざめ	興ざめ	抑制単語	興醒め
きょうざめ	興ざめ	抑制単語	興醒め
きょうざめし	興ざめし	抑制単語	興醒めし
きょうざめする	興ざめする	抑制単語	興醒めする
きょうじん	強じん	抑制単語	強靱
きょうじん	強じん	抑制単語	強靭
きょうじん	強じん	抑制単語	強靱
きょうすごい	今日すごい	抑制単語	今日凄い
きょうすごかっ	今日すごかっ	抑制単語	今日凄かっ
きょうすごく	今日すごく	抑制単語	今日凄く
きょうせい	きょう正	抑制単語	匡正
きょうどう	きょう導	抑制単語	嚮導
きょうべん	教べん	抑制単語	教鞭
きょうみしんしん	興味しんしん	抑制単語	興味津々
きょうみをひい	興味をひい	抑制単語	興味を惹い
きょうみをひか	興味をひか	抑制単語	興味を惹か
きょうみをひき	興味をひき	抑制単語	興味を惹き
きょうみをひきつけ	興味をひきつけ	抑制単語	興味を惹きつけ
きょうみをひく	興味をひく	抑制単語	興味を惹く
きょうものすごい	今日ものすごい	抑制単語	今日物凄い
きょうものすごく	今日ものすごく	抑制単語	今日物凄く
きょうりょう	橋りょう	抑制単語	橋梁
きょねんなつごろ	去年夏ごろ	抑制単語	去年夏頃
きらぼし	きら星	抑制単語	綺羅星
きらめきかがやく	きらめき輝く	抑制単語	煌めき輝く
きりおとし	切り落とし	抑制単語	斬り落し
きりこ	切り子	抑制単語	切籠
きりそろえ	切りそろえ	抑制単語	切り揃え
きりそろえ	切りそろえ	抑制単語	切り揃え
きりそろえる	切りそろえる	抑制単語	切り揃える
きりまわし	切りまわし	抑制単語	切り廻し
きりまわし	切りまわし	抑制単語	切廻し
きりまわし	切り回し	抑制単語	切廻し
きれいかわいい	きれい可愛い	抑制単語	綺麗可愛い
きれいきたない	きれい汚い	抑制単語	綺麗汚い
きれいけい	きれい系	抑制単語	綺麗系
きれいごと	きれい事	抑制単語	綺麗事
きれいしょく	きれい色	抑制単語	綺麗色
きれいすき	きれい好き	抑制単語	綺麗好き
きれいすき	きれい好き	抑制単語	綺麗好き
きれいめ	きれい目	抑制単語	綺麗目
きれいや	きれい屋	抑制単語	綺麗屋
きれじ	切れ字	抑制単語	切痔
きれつ	き裂	抑制単語	亀裂
きをてらい	奇をてらい	抑制単語	奇を衒い
きをてらう	奇をてらう	抑制単語	奇を衒う
きをてらっ	奇をてらっ	抑制単語	奇を衒っ
きをてらわ	奇をてらわ	抑制単語	奇を衒わ
きをもま	気をもま	抑制単語	気を揉ま
きをもみ	気をもみ	抑制単語	気を揉み
きをもむ	気をもむ	抑制単語	気を揉む
きをもん	気をもん	抑制単語	気を揉ん
きんぎょすくい	金魚すくい	抑制単語	金魚掬い
きんこつたくましい	筋骨たくましい	抑制単語	筋骨逞しい
きんたろうあめ	金太郎あめ	抑制単語	金太郎飴
きんちゃくぶくろ	きんちゃく袋	抑制単語	巾着袋
きんつば	金つば	抑制単語	金鍔
きんてん	均てん	抑制単語	均霑
きんぱく	金ぱく	抑制単語	金箔
ぎそう	ぎ装	抑制単語	艤装
ぎまん	欺まん	抑制単語	欺瞞
ぎゃくまつげ	逆まつげ	抑制単語	逆睫毛
ぎゅうなべ	牛なべ	抑制単語	牛鍋
ぎゅうふん	牛ふん	抑制単語	牛糞
ぎょうが	仰が	抑制単語	仰臥
ぎょうざや	ぎょうざ屋	抑制単語	餃子屋
ぎょうちゅう	ぎょう虫	抑制単語	蟯虫
ぎんぱく	銀ぱく	抑制単語	銀箔
ぎんりん	銀りん	抑制単語	銀鱗
くいこま	くい込ま	抑制単語	喰い込ま
くいこみ	くい込み	抑制単語	喰い込み
くいこむ	くい込む	抑制単語	喰い込む
くいこめる	くい込める	抑制単語	喰い込める
くいこん	くい込ん	抑制単語	喰い込ん
くいだめ	食いだめ	抑制単語	食い溜め
くいちがっ	くい違っ	抑制単語	喰い違っ
くいつくさ	食い尽くさ	抑制単語	喰い尽さ
くいつなげ	食いつなげ	抑制単語	食い繋げ
くいつなげる	食いつなげる	抑制単語	食い繋げる
くいつぶさ	食いつぶさ	抑制単語	食い潰さ
くいつぶし	食いつぶし	抑制単語	食い潰し
くいつぶす	食いつぶす	抑制単語	食い潰す
くいつぶそ	食いつぶそ	抑制単語	食い潰そ
くいつぶそう	食いつぶそう	抑制単語	食い潰そう
くいとめ	くい止め	抑制単語	喰い止め
くいとめる	くい止める	抑制単語	喰い止める
くうてい	空てい	抑制単語	空挺
くがつごろ	九月ごろ	抑制単語	9月頃
くがつごろ	九月ごろ	抑制単語	九月頃
くぎに	くぎ煮	抑制単語	釘煮
くさびをうちこみ	くさびを打ち込み	抑制単語	楔を打ち込み
くさびをうちこむ	くさびを打ち込む	抑制単語	楔を打ち込む
くさびをうちこん	くさびを打ち込ん	抑制単語	楔を打ち込ん
くさもち	草もち	抑制単語	草餅
くさやぶ	草やぶ	抑制単語	草薮
くさやぶ	草やぶ	抑制単語	草藪
くしやき	くし焼き	抑制単語	串焼
くしやき	くし焼き	抑制単語	串焼き
くじうん	くじ運	抑制単語	籤運
くじごろ	九時ごろ	抑制単語	九時頃
くじはんごろ	九時半ごろ	抑制単語	九時半頃
くじゅうをなめ	苦汁をなめ	抑制単語	苦汁を舐め
くじゅうをなめ	苦汁をなめ	抑制単語	苦汁を舐め
くずこ	くず粉	抑制単語	葛粉
くずてつ	くず鉄	抑制単語	屑鉄
くずまい	くず米	抑制単語	屑米
くそじから	くそ力	抑制単語	糞力
くそぢから	くそ力	抑制単語	糞力
くそどきょう	くそ度胸	抑制単語	糞度胸
くちげんか	口げんか	抑制単語	口喧嘩
くちごもっ	口ごもっ	抑制単語	口篭っ
くちごもっ	口ごもっ	抑制単語	口籠っ
くちごもる	口ごもる	抑制単語	口篭る
くちごもる	口ごもる	抑制単語	口籠る
くちさびしい	口さびしい	抑制単語	口淋しい
くちばしがきいろい	くちばしが黄色い	抑制単語	嘴が黄色い
くちひげ	口ひげ	抑制単語	口髭
くちやかましい	口やかましい	抑制単語	口喧しい
くちやかましく	口やかましく	抑制単語	口喧しく
くちをつぐみ	口をつぐみ	抑制単語	口を噤み
くちをつぐむ	口をつぐむ	抑制単語	口を噤む
くちをつぐん	口をつぐん	抑制単語	口を噤ん
くちをとがらし	口をとがらし	抑制単語	口を尖らし
くちをとがらす	口をとがらす	抑制単語	口を尖らす
くちをとがらせ	口をとがらせ	抑制単語	口を尖らせ
くちをふさい	口をふさい	抑制単語	口を塞い
くちをふさが	口をふさが	抑制単語	口を塞が
くちをふさぎ	口をふさぎ	抑制単語	口を塞ぎ
くちをふさぐ	口をふさぐ	抑制単語	口を塞ぐ
くちをふさごう	口をふさごう	抑制単語	口を塞ごう
くつひも	靴ひも	抑制単語	靴紐
くつろぎいただけ	寛ぎいただけ	抑制単語	寛ぎ戴け
くになまり	国なまり	抑制単語	国訛
くになまり	国なまり	抑制単語	国訛り
くはいをなめ	苦杯をなめ	抑制単語	苦杯を嘗め
くびかせ	首かせ	抑制単語	首枷
くびがつながっ	首がつながっ	抑制単語	首が繋がっ
くびくくり	首くくり	抑制単語	首縊り
くびつり	首つり	抑制単語	首吊
くびつり	首つり	抑制単語	首吊り
くびつりじさつ	首つり自殺	抑制単語	首吊り自殺
くびりころさ	くびり殺さ	抑制単語	縊り殺さ
くびりころし	くびり殺し	抑制単語	縊り殺し
くみあげ	くみ上げ	抑制単語	汲み上げ
くみあげ	くみ上げ	抑制単語	汲み上げ
くみあげる	くみ上げる	抑制単語	汲み上げる
くみあげれ	くみ上げれ	抑制単語	汲み上げれ
くみいれ	くみ入れ	抑制単語	汲み入れ
くみおき	くみ置き	抑制単語	汲み置き
くみおきし	くみ置きし	抑制単語	汲み置きし
くみおきする	くみ置きする	抑制単語	汲み置きする
くみださ	くみ出さ	抑制単語	汲み出さ
くみだし	くみ出し	抑制単語	汲み出し
くみだす	くみ出す	抑制単語	汲み出す
くみと	くみ取	抑制単語	汲み取
くみとっ	くみ取っ	抑制単語	汲み取っ
くみとってほしい	くみ取ってほしい	抑制単語	汲み取ってほしい
くみとら	くみ取ら	抑制単語	汲み取ら
くみとり	くみ取り	抑制単語	汲み取り
くみとる	くみ取る	抑制単語	汲み取る
くみとれ	くみ取れ	抑制単語	汲み取れ
くみとれ	くみ取れ	抑制単語	汲み取れ
くみとれる	くみ取れる	抑制単語	汲み取れる
くみとろ	くみ取ろ	抑制単語	汲み取ろ
くものす	くもの巣	抑制単語	蜘蛛の巣
くもまく	くも膜	抑制単語	蜘蛛膜
くもん	苦もん	抑制単語	苦悶
くらいすごい	位すごい	抑制単語	位凄い
くらがえ	くら替え	抑制単語	鞍替え
くらしにあこがれ	暮らしにあこがれ	抑制単語	暮らしに憧れ
くらしになじむ	暮らしになじむ	抑制単語	暮らしに馴染む
くらやみ	暗やみ	抑制単語	暗闇
くりかえしたたき	繰り返したたき	抑制単語	繰り返し叩き
くりかえしたどりつい	繰り返したどり着い	抑制単語	繰り返し辿り着い
くりかえしつぶやい	繰り返しつぶやい	抑制単語	繰り返し呟い
くりかえしつぶやき	繰り返しつぶやき	抑制単語	繰り返し呟き
くりかえしつぶやく	繰り返しつぶやく	抑制単語	繰り返し呟く
くりぬい	くり抜い	抑制単語	刳り抜い
くりぬい	くり貫い	抑制単語	刳り貫い
くりぬか	くり抜か	抑制単語	刳り抜か
くりぬか	くり貫か	抑制単語	刳り貫か
くりぬき	くり抜き	抑制単語	刳り抜き
くりぬき	くり貫き	抑制単語	刳り貫き
くりぬく	くり抜く	抑制単語	刳り抜く
くりぬく	くり貫く	抑制単語	刳り貫く
くるしみもだえ	苦しみもだえ	抑制単語	苦しみ悶え
くるしみもだえる	苦しみもだえる	抑制単語	苦しみ悶える
くるまいす	車いす	抑制単語	車椅子
くるまいすすぺーす	車いすスペース	抑制単語	車椅子スペース
くるまいすせいかつ	車いす生活	抑制単語	車椅子生活
くるまいすたいおう	車いす対応	抑制単語	車椅子対応
くるまいすたいおうといれ	車いす対応トイレ	抑制単語	車椅子対応トイレ
くるまいすのほう	車いすの方	抑制単語	車椅子の方
くるまいすゆーざー	車いすユーザー	抑制単語	車椅子ユーザー
くるまいすよう	車いす用	抑制単語	車椅子用
くるまいすりようしゃ	車いす利用者	抑制単語	車椅子利用者
くるまえび	車えび	抑制単語	車蝦
くるまひき	車引き	抑制単語	車曳
くるめがすり	久留米がすり	抑制単語	久留米絣
くろうさぎ	黒うさぎ	抑制単語	黒兎
くろこしょう	黒こしょう	抑制単語	黒胡椒
くろごま	黒ごま	抑制単語	黒胡麻
くろつぶれ	黒つぶれ	抑制単語	黒潰れ
くろひげ	黒ひげ	抑制単語	黒髭
くろひょう	黒ひょう	抑制単語	黒豹
くろみつ	黒みつ	抑制単語	黒蜜
くわえこみ	くわえ込み	抑制単語	咥え込み
くわえこむ	くわえ込む	抑制単語	咥え込む
くわえこん	くわえ込ん	抑制単語	咥え込ん
くわがたむし	くわがた虫	抑制単語	鍬形虫
くんじょう	くん蒸	抑制単語	燻蒸
くんせい	くん製	抑制単語	燻製
ぐろう	愚ろう	抑制単語	愚弄
けいえいはたん	経営破たん	抑制単語	経営破綻
けいがい	形がい	抑制単語	形骸
けいけん	敬けん	抑制単語	敬虔
けいこ	けい古	抑制単語	稽古
けいこつ	けい骨	抑制単語	脛骨
けいこつ	けい骨	抑制単語	頚骨
けいこつ	けい骨	抑制単語	頸骨
けいそ	けい素	抑制単語	珪素
けいそ	けい素	抑制単語	硅素
けいどうみゃく	けい動脈	抑制単語	頚動脈
けいどうみゃく	けい動脈	抑制単語	頸動脈
けいのり	軽乗り	抑制単語	軽海苔
けいふん	鶏ふん	抑制単語	鶏糞
けいべつ	軽べつ	抑制単語	軽蔑
けいもう	啓もう	抑制単語	啓蒙
けいら	警ら	抑制単語	警邏
けいれんせい	けいれん性	抑制単語	痙攣性
けいれんほっさ	けいれん発作	抑制単語	痙攣発作
けおとし	け落とし	抑制単語	蹴落し
けおとし	け落とし	抑制単語	蹴落とし
けおとす	け落とす	抑制単語	蹴落す
けおとす	け落とす	抑制単語	蹴落とす
けがに	毛がに	抑制単語	毛蟹
けがはえそろう	毛が生えそろう	抑制単語	毛が生え揃う
けがはえそろっ	毛が生えそろっ	抑制単語	毛が生え揃っ
けじらみ	毛じらみ	抑制単語	毛虱
けたすう	けた数	抑制単語	桁数
けっかすごい	結果すごい	抑制単語	結果凄い
けっかすごく	結果すごく	抑制単語	結果凄く
けっきょくあきらめ	結局あきらめ	抑制単語	結局諦め
けっきょくすごい	結局すごい	抑制単語	結局凄い
けっしょう	血しょう	抑制単語	血漿
けったん	血たん	抑制単語	血痰
けっちょうがん	結腸がん	抑制単語	結腸癌
けとばし	け飛ばし	抑制単語	蹴飛ばし
けばり	毛ばり	抑制単語	毛鉤
けりあげ	けり上げ	抑制単語	蹴り上げ
けりおとし	けり落とし	抑制単語	蹴り落とし
けりこみ	けり込み	抑制単語	蹴り込み
けりこむ	けり込む	抑制単語	蹴り込む
けりころし	けり殺し	抑制単語	蹴り殺し
けりこん	けり込ん	抑制単語	蹴り込ん
けりたおし	けり倒し	抑制単語	蹴り倒し
けりだし	けり出し	抑制単語	蹴り出し
けりだす	けり出す	抑制単語	蹴り出す
けんいん	けん引	抑制単語	牽引
けんいんしゃ	けん引車	抑制単語	牽引者
けんいんしゃ	けん引車	抑制単語	牽引車
けんいんめんきょ	けん引免許	抑制単語	牽引免許
けんいんやく	けん引役	抑制単語	牽引役
けんか	けん化	抑制単語	鹸化
けんかごし	けんか腰	抑制単語	喧嘩腰
けんかっぱやい	けんかっ早い	抑制単語	喧嘩っ早い
けんかっぱやく	けんかっ早く	抑制単語	喧嘩っ早く
けんかまつり	けんか祭り	抑制単語	喧嘩祭り
けんかをうら	けんかを売ら	抑制単語	喧嘩を売ら
けんかをうる	けんかを売る	抑制単語	喧嘩を売る
けんさん	研さん	抑制単語	研鑚
けんさん	研さん	抑制単語	研鑽
けんじゅう	けん銃	抑制単語	拳銃
けんせい	けん制	抑制単語	牽制
けんせき	けん責	抑制単語	譴責
けんそう	けん騒	抑制単語	喧騒
けんそん	謙そん	抑制単語	謙遜
けんたい	けん怠	抑制単語	倦怠
けんたいかん	けん怠感	抑制単語	倦怠感
けんばん	けん盤	抑制単語	鍵盤
けんぺいりつ	建ぺい率	抑制単語	建蔽率
げきやせ	激やせ	抑制単語	激痩せ
げじゅんごろ	下旬ごろ	抑制単語	下旬頃
げっしるい	げっ歯類	抑制単語	齧歯類
げんき	げん気	抑制単語	衒気
げんきもらえ	元気もらえ	抑制単語	元気貰え
げんざいすごい	現在すごい	抑制単語	現在凄い
げんざいすごく	現在すごく	抑制単語	現在凄く
こあじ	小あじ	抑制単語	小鯵
こあじ	小あじ	抑制単語	小鰺
こいす	小いす	抑制単語	小椅子
こいびとつなぎ	恋人つなぎ	抑制単語	恋人繋ぎ
こいわし	小いわし	抑制単語	小鰯
こううつざい	抗うつ剤	抑制単語	抗欝剤
こううつやく	抗うつ薬	抑制単語	抗欝薬
こううん	耕うん	抑制単語	耕耘
こうかてきめん	効果てきめん	抑制単語	効果覿面
こうがん	こう丸	抑制単語	睾丸
こうきゅうすしや	高級すし屋	抑制単語	高級鮨屋
こうけいれん	抗けいれん	抑制単語	抗痙攣
こうけいれんざい	抗けいれん剤	抑制単語	抗痙攣剤
こうけいれんやく	抗けいれん薬	抑制単語	抗痙攣薬
こうさい	鉱さい	抑制単語	鉱滓
こうさぎ	子うさぎ	抑制単語	子兎
こうし	子うし	抑制単語	庚子
こうしょう	こう笑	抑制単語	哄笑
こうしょう	口しょう	抑制単語	口誦
こうしん	こう進	抑制単語	亢進
こうしん	こう進	抑制単語	昂進
こうじょうせん	甲状せん	抑制単語	甲状腺
こうじん	後じん	抑制単語	後塵
こうすそ	後すそ	抑制単語	後裾
こうたんぱく	高たんぱく	抑制単語	高蛋白
こうたんぱくしょく	高たんぱく食	抑制単語	高蛋白食
こうちゃく	こう着	抑制単語	膠着
こうちゃくじょうたい	こう着状態	抑制単語	膠着状態
こうとう	こう頭	抑制単語	叩頭
こうはんごろ	後半ごろ	抑制単語	後半頃
こうばい	こう配	抑制単語	勾配
こうひょう	降ひょう	抑制単語	降雹
こうもりがさ	こうもり傘	抑制単語	蝙蝠傘
こうもん	こう門	抑制単語	拱門
こうもん	こう門	抑制単語	肛門
こうもん	こう門	抑制単語	閘門
こうらやましい	子うらやましい	抑制単語	子羨ましい
こうりゅう	こう留	抑制単語	勾留
こえがかれ	声がかれ	抑制単語	声が嗄れ
こえすごい	声すごい	抑制単語	声凄い
こえすごく	声すごく	抑制単語	声凄く
こえをからし	声をからし	抑制単語	声を嗄らし
こおりまくら	氷まくら	抑制単語	氷枕
こかげ	木かげ	抑制単語	木蔭
こぎだし	こぎ出し	抑制単語	漕ぎ出し
こぎだす	こぎ出す	抑制単語	漕ぎ出す
こぎだそ	こぎ出そ	抑制単語	漕ぎ出そ
こぎつけ	こぎ着け	抑制単語	漕ぎ着け
こぎつけ	こぎ着け	抑制単語	漕ぎ着け
こぎつける	こぎ着ける	抑制単語	漕ぎ着ける
こぎつね	小ぎつね	抑制単語	小狐
こぎれい	小ぎれい	抑制単語	小綺麗
こけいせっけん	固形石けん	抑制単語	固形石鹸
こけらおとし	こけら落し	抑制単語	柿落し
こけらおとし	こけら落とし	抑制単語	柿落し
こころからうらやましく	心からうらやましく	抑制単語	心から羨ましく
こころからうれし	心からうれし	抑制単語	心から嬉し
こころからうれしい	心からうれしい	抑制単語	心から嬉しい
こころからうれしかっ	心からうれしかっ	抑制単語	心から嬉しかっ
こころからうれしく	心からうれしく	抑制単語	心から嬉しく
こころからすごい	心からすごい	抑制単語	心から凄い
こころばせ	心ばせ	抑制単語	心馳せ
こころをつかま	心をつかま	抑制単語	心を掴ま
こころをつかみ	心をつかみ	抑制単語	心を掴み
こころをつかむ	心をつかむ	抑制単語	心を掴む
こころをつかん	心をつかん	抑制単語	心を掴ん
こころをとらえる	心を捕らえる	抑制単語	心を捉える
こさじ	小さじ	抑制単語	小匙
こしぎんちゃく	腰ぎんちゃく	抑制単語	腰巾着
こしだめ	腰だめ	抑制単語	腰溜め
こしとっ	こし取っ	抑制単語	濾し取っ
こしとり	こし取り	抑制単語	濾し取り
こしとる	こし取る	抑制単語	濾し取る
こしぬの	こし布	抑制単語	漉し布
こしぬの	こし布	抑制単語	濾し布
こしひも	腰ひも	抑制単語	腰紐
こしみの	腰みの	抑制単語	腰蓑
こじあけ	こじ開け	抑制単語	抉じ開け
こじあけ	こじ開け	抑制単語	抉じ開け
こじあける	こじ開ける	抑制単語	抉じ開ける
こじわ	小じわ	抑制単語	小皺
こじんじょうほうろうえい	個人情報漏えい	抑制単語	個人情報漏洩
こすごい	子すごい	抑制単語	子凄い
こすごく	子すごく	抑制単語	子凄く
こすずめ	子すずめ	抑制単語	子雀
こずち	小づち	抑制単語	小槌
こたえにたどりつい	答えにたどり着い	抑制単語	答えに辿り着い
こたえにたどりつき	答えにたどり着き	抑制単語	答えに辿り着き
こたえにたどりつく	答えにたどり着く	抑制単語	答えに辿り着く
こたえにつながる	答えにつながる	抑制単語	答えに繋がる
こっとう	骨とう	抑制単語	骨董
こっとうひん	骨とう品	抑制単語	骨董品
こっぱみじん	木っ端みじん	抑制単語	木っ端微塵
こっぱみじん	木っ端みじん	抑制単語	木端微塵
こつつぼ	骨つぼ	抑制単語	骨壷
こつつぼ	骨つぼ	抑制単語	骨壺
こづち	小づち	抑制単語	小槌
ことしすごい	今年すごい	抑制単語	今年凄い
ことしなつごろ	今年夏ごろ	抑制単語	今年夏頃
ことなかれしゅぎ	ことなかれ主義	抑制単語	事勿れ主義
ことばじり	言葉じり	抑制単語	言葉尻
こどもだまし	子供だまし	抑制単語	子供騙し
こどんぶり	小どんぶり	抑制単語	小丼
こなす	小なす	抑制単語	小茄子
こなみじん	粉みじん	抑制単語	粉微塵
こぬかあめ	こぬか雨	抑制単語	小糠雨
こねあがっ	こね上がっ	抑制単語	捏ね上がっ
こねあがり	こね上がり	抑制単語	捏ね上がり
こねぎ	小ねぎ	抑制単語	小葱
こねくりまわし	こねくり回し	抑制単語	捏ねくり回し
こねくりまわし	こねくり回し	抑制単語	捏ね繰り回し
こねくりまわす	こねくり回す	抑制単語	捏ねくり回す
こねくりまわす	こねくり回す	抑制単語	捏ね繰り回す
こねまわし	こね回し	抑制単語	捏ね回し
こねまわす	こね回す	抑制単語	捏ね回す
このあいだ	この間	抑制単語	此の間
このうち	この内	抑制単語	此の内
このかた	この方	抑制単語	此の方
このかん	この間	抑制単語	此の間
このさい	この際	抑制単語	此の際
このさき	この先	抑制単語	此の先
このせつ	この節	抑制単語	此の節
このたび	この度	抑制単語	此の度
このほど	この程	抑制単語	此の程
このまえ	この前	抑制単語	此の前
このよ	この世	抑制単語	此の世
こびうっ	こび売っ	抑制単語	媚び売っ
こびん	小びん	抑制単語	小鬢
こふくさ	古ふくさ	抑制単語	古袱紗
こまいぬ	こま犬	抑制単語	狛犬
こまた	小また	抑制単語	小股
こまをすすめ	こまを進め	抑制単語	駒を進め
こみあいつながり	混み合いつながり	抑制単語	混み合い繋がり
こめつき	米つき	抑制単語	米搗き
こめぬか	米ぬか	抑制単語	米糠
こめびつ	米びつ	抑制単語	米櫃
こもち	子もち	抑制単語	子餅
こもりやど	こもり宿	抑制単語	籠り宿
これほどうれしい	これ程うれしい	抑制単語	これ程嬉しい
こわき	小わき	抑制単語	小脇
こんかいうれしかっ	今回うれしかっ	抑制単語	今回嬉しかっ
こんかいすごい	今回すごい	抑制単語	今回凄い
こんかいすごく	今回すごく	抑制単語	今回凄く
こんがすり	紺がすり	抑制単語	紺絣
こんしん	こん身	抑制単語	渾身
こんじ	今ぢ	抑制単語	今茲
こんすい	こん睡	抑制単語	昏睡
こんちまた	今ちまた	抑制単語	今巷
こんとん	混とん	抑制単語	混沌
こんぱい	困ぱい	抑制単語	困憊
こんぺき	紺ぺき	抑制単語	紺碧
こんぼう	こん棒	抑制単語	棍棒
こんぽう	こん包	抑制単語	梱包
ごい	語い	抑制単語	語彙
ごうおん	ごう音	抑制単語	轟音
ごうかん	強かん	抑制単語	強姦
ごうし	合し	抑制単語	合祀
ごうまん	ごう慢	抑制単語	傲慢
ごうまん	ごう慢	抑制単語	傲慢
ごがつごろ	五月ごろ	抑制単語	5月頃
ごがつごろ	五月ごろ	抑制単語	五月頃
ごくごくいちぶ	ごくごく一部	抑制単語	極々一部
ごくごくさいきん	ごくごく最近	抑制単語	極々最近
ごくごくしょうりょう	ごくごく少量	抑制単語	極々少量
ごくらくとんぼ	極楽とんぼ	抑制単語	極楽蜻蛉
ごこくほうじょう	五穀豊じょう	抑制単語	五穀豊穣
ごさん	午さん	抑制単語	午餐
ごじごろ	五時ごろ	抑制単語	五時頃
ごじはんごろ	五時半ごろ	抑制単語	五時半頃
ごすんくぎ	五寸くぎ	抑制単語	五寸釘
ごそば	御そば	抑制単語	御蕎麦
ごちそうさま	ごちそう様	抑制単語	ご馳走様
ごちそうさま	ごちそう様	抑制単語	御馳走様
ごちそうたべ	ごちそう食べ	抑制単語	ご馳走食べ
ごねんごろ	五年ごろ	抑制単語	五年頃
ごひいき	御ひいき	抑制単語	御贔屓
ごびゅう	誤びゅう	抑制単語	誤謬
ごまあぶら	ごま油	抑制単語	胡麻油
ごましお	ごま塩	抑制単語	胡麻塩
ごまどうふ	ごま豆腐	抑制単語	胡麻豆腐
ごめんこうむり	ご免こうむり	抑制単語	御免蒙り
ごめんこうむり	ご免被り	抑制単語	御免蒙り
ごめんこうむり	御免こうむり	抑制単語	御免蒙り
ごめんこうむる	ご免こうむる	抑制単語	御免蒙る
ごめんこうむる	ご免被る	抑制単語	御免蒙る
ごめんこうむる	御免こうむる	抑制単語	御免蒙る
ごもち	御持ち	抑制単語	御餅
ごらんいただけ	ご覧いただけ	抑制単語	ご覧戴け
ごらんいただけ	御覧いただけ	抑制単語	ご覧戴け
さいきんうれしい	最近うれしい	抑制単語	最近嬉しい
さいきんうれしかっ	最近うれしかっ	抑制単語	最近嬉しかっ
さいきんすごい	最近すごい	抑制単語	最近凄い
さいきんすごく	最近すごく	抑制単語	最近凄く
さいきんものすごい	最近ものすごい	抑制単語	最近物凄い
さいきんものすごく	最近ものすごく	抑制単語	最近物凄く
さいごすごい	最後すごい	抑制単語	最後凄い
さいごっぺ	最後っぺ	抑制単語	最後っ屁
さいしょすごい	最初すごい	抑制単語	最初凄い
さいしょすごく	最初すごく	抑制単語	最初凄く
さいのめ	さいの目	抑制単語	賽の目
さいのめ	さいの目	抑制単語	采の目
さいはい	さい配	抑制単語	采配
さいはくり	再はくり	抑制単語	再剥離
さいはつがん	再発がん	抑制単語	再発癌
さいばし	菜ばし	抑制単語	菜箸
さえわたっ	さえ渡っ	抑制単語	冴え渡っ
さえわたり	さえ渡り	抑制単語	冴え渡り
さえわたる	さえ渡る	抑制単語	冴え渡る
さおだけ	さお竹	抑制単語	竿竹
さかさまつげ	逆さまつげ	抑制単語	逆さ睫
さかだる	酒だる	抑制単語	酒樽
さかなで	逆なで	抑制単語	逆撫で
さかなで	逆なで	抑制単語	逆撫で
さかなでる	逆なでる	抑制単語	逆撫でる
さかなや	さかな屋	抑制単語	肴屋
さきあふれ	咲きあふれ	抑制単語	咲き溢れ
さきあふれる	咲きあふれる	抑制単語	咲き溢れる
さきごろ	先ごろ	抑制単語	先頃
さきそろい	咲きそろい	抑制単語	咲き揃い
さきそろう	咲きそろう	抑制単語	咲き揃う
さきそろっ	咲きそろっ	抑制単語	咲き揃っ
さくしさくにおぼれる	策士策におぼれる	抑制単語	策士策に溺れる
さくせい	さく井	抑制単語	鑿井
さくそう	錯そう	抑制単語	錯綜
さくねんごろ	昨年ごろ	抑制単語	昨年頃
さくねんなつごろ	昨年夏ごろ	抑制単語	昨年夏頃
さくらもち	桜もち	抑制単語	桜餅
さくれつ	さく裂	抑制単語	炸裂
さけかす	酒かす	抑制単語	酒粕
さけかす	酒かす	抑制単語	酒糟
ささみ	ささ身	抑制単語	笹身
さじかげん	さじ加減	抑制単語	匙加減
さじをなげる	さじを投げる	抑制単語	匙を投げる
さじん	砂じん	抑制単語	砂塵
さそりざ	さそり座	抑制単語	蠍座
さっそくうれしい	早速うれしい	抑制単語	早速嬉しい
さっそくすごい	早速すごい	抑制単語	早速凄い
さつまあげ	さつま揚げ	抑制単語	薩摩揚
さつまいも	さつま芋	抑制単語	薩摩芋
さつりく	殺りく	抑制単語	殺戮
さとうきび	砂糖きび	抑制単語	砂糖黍
さばかん	さば缶	抑制単語	鯖缶
さびおとし	さび落とし	抑制単語	錆び落し
さびおとし	さび落とし	抑制単語	錆び落とし
さびつい	さび付い	抑制単語	錆び付い
さびつい	さび付い	抑制単語	錆付い
さびつか	さび付か	抑制単語	錆び付か
さびつか	さび付か	抑制単語	錆付か
さびつかせない	さび付かせない	抑制単語	錆び付かせない
さびつき	さび付き	抑制単語	錆び付き
さびつき	さび付き	抑制単語	錆付き
さびつく	さび付く	抑制単語	錆び付く
さびつく	さび付く	抑制単語	錆付く
さびとめ	さび止め	抑制単語	錆び止め
さまよいあるい	さまよい歩い	抑制単語	彷徨い歩い
さまよいあるい	さ迷い歩い	抑制単語	彷徨い歩い
さまよいあるき	さまよい歩き	抑制単語	彷徨い歩き
さまよいあるき	さ迷い歩き	抑制単語	彷徨い歩き
さまよいあるく	さまよい歩く	抑制単語	彷徨い歩く
さまよいあるく	さ迷い歩く	抑制単語	彷徨い歩く
さまよいこん	さまよい込ん	抑制単語	彷徨い込ん
さまよいで	さまよい出	抑制単語	彷徨い出
さまよいで	さ迷い出	抑制単語	彷徨い出
さまよいでる	さまよい出る	抑制単語	彷徨い出る
さむざむ	寒ざむ	抑制単語	寒々
さらけださ	さらけ出さ	抑制単語	曝け出さ
さらけだし	さらけ出し	抑制単語	曝け出し
さらけだす	さらけ出す	抑制単語	曝け出す
さらけだせ	さらけ出せ	抑制単語	曝け出せ
さらけだせ	さらけ出せ	抑制単語	曝け出せ
さらけだそ	さらけ出そ	抑制単語	曝け出そ
さらしあげ	さらし上げ	抑制単語	晒し上げ
さらしくび	さらし首	抑制単語	晒首
さらしこ	さらし粉	抑制単語	晒粉
さらしもの	さらし者	抑制単語	晒者
さらしもめん	さらし木綿	抑制単語	晒木綿
さらにうれしい	更にうれしい	抑制単語	更に嬉しい
さらにうれしかっ	更にうれしかっ	抑制単語	更に嬉しかっ
さらにうれしく	更にうれしく	抑制単語	更に嬉しく
さらにすごい	更にすごい	抑制単語	更に凄い
さらにすごかっ	更にすごかっ	抑制単語	更に凄かっ
さらにすごく	更にすごく	抑制単語	更に凄く
さらにたくましく	更にたくましく	抑制単語	更に逞しく
さらにものすごい	更にものすごい	抑制単語	更に物凄い
さらまわし	皿まわし	抑制単語	皿廻し
さるぐつわ	猿ぐつわ	抑制単語	猿轡
されき	砂れき	抑制単語	砂礫
さわやかかん	さわやか感	抑制単語	爽やか感
さわやかけい	さわやか系	抑制単語	爽やか系
さわやかど	さわやか度	抑制単語	爽やか度
さんかくきん	三角きん	抑制単語	三角巾
さんがつごろ	三月ごろ	抑制単語	3月頃
さんがつごろ	三月ごろ	抑制単語	三月頃
さんこう	さん孔	抑制単語	鑽孔
さんごしょう	さんご礁	抑制単語	珊瑚礁
さんじごろ	三時ごろ	抑制単語	三時頃
さんじょく	産じょく	抑制単語	産褥
さんすくみ	三すくみ	抑制単語	三竦み
さんぜん	さん然	抑制単語	燦然
さんたん	惨たん	抑制単語	惨澹
さんねんごろ	三年ごろ	抑制単語	三年頃
さんばがらす	三羽がらす	抑制単語	三羽烏
さんろう	参ろう	抑制単語	参篭
さんろう	参ろう	抑制単語	参籠
さんろく	山ろく	抑制単語	山麓
ざいす	座いす	抑制単語	座椅子
ざぶとん	座ぶとん	抑制単語	座蒲団
ざんげん	ざん言	抑制単語	讒言
ざんしん	ざん新	抑制単語	斬新
しあがりはば	仕上がり幅	抑制単語	仕上り巾
しおこしょう	塩こしょう	抑制単語	塩胡椒
しおさば	塩さば	抑制単語	塩鯖
しおもみ	塩もみ	抑制単語	塩揉み
しかしながら	然しながら	抑制単語	然し乍ら
しかりとばし	しかり飛ばし	抑制単語	叱り飛ばし
しがい	死がい	抑制単語	死骸
しがつごろ	四月ごろ	抑制単語	4月頃
しがつごろ	四月ごろ	抑制単語	四月頃
しきいち	しきい値	抑制単語	閾値
しきいをまたぐ	敷居をまたぐ	抑制単語	敷居を跨ぐ
しきゅうがん	子宮がん	抑制単語	子宮癌
しこう	し好	抑制単語	嗜好
しこう	歯こう	抑制単語	歯垢
しさい	し細	抑制単語	仔細
ししゅう	刺しゅう	抑制単語	刺繍
ししゅう	刺しゅう	抑制単語	刺繡
ししゅういと	刺しゅう糸	抑制単語	刺繍糸
ししゅうきっと	刺しゅうキット	抑制単語	刺繍キット
ししゅうみしん	刺しゅうミシン	抑制単語	刺繍ミシン
ししゅうわく	刺しゅう枠	抑制単語	刺繍枠
ししゅうわっぺん	刺しゅうワッペン	抑制単語	刺繍ワッペン
ししょう	し笑	抑制単語	嗤笑
しずくがた	しずく型	抑制単語	雫型
しそうのうろう	歯槽のうろう	抑制単語	歯槽膿漏
したごしらえ	下ごしらえ	抑制単語	下拵え
したしみあふれる	親しみあふれる	抑制単語	親しみ溢れる
したしみわい	親しみわい	抑制単語	親しみ湧い
したしみわく	親しみわく	抑制単語	親しみ湧く
したどりつい	したどり着い	抑制単語	し辿り着い
したなめずり	舌なめずり	抑制単語	舌舐めずり
したゆで	下ゆで	抑制単語	下茹で
しちがつごろ	七月ごろ	抑制単語	7月頃
しちがつごろ	七月ごろ	抑制単語	七月頃
しちじごろ	七時ごろ	抑制単語	七時頃
しちねんごろ	七年ごろ	抑制単語	七年頃
しちょう	し張	抑制単語	弛張
しっしん	湿しん	抑制単語	湿疹
しっせき	しっ責	抑制単語	叱責
しっそう	失そう	抑制単語	失踪
しつけいと	しつけ糸	抑制単語	躾糸
しつけいと	仕付け糸	抑制単語	躾糸
しつよう	執よう	抑制単語	執拗
しなぞろえ	品ぞろえ	抑制単語	品揃え
しにさらせ	死にさらせ	抑制単語	死に晒せ
しにつながる	死につながる	抑制単語	死に繋がる
しにょう	し尿	抑制単語	屎尿
しはらいいただき	支払いいただき	抑制単語	支払い戴き
しはらいいただく	支払いいただく	抑制単語	支払い戴く
しばいぬ	しば犬	抑制単語	柴犬
しびれきらし	しびれ切らし	抑制単語	痺れ切らし
しびれをきらし	しびれを切らし	抑制単語	痺れを切らし
しびれをきらす	しびれを切らす	抑制単語	痺れを切らす
しまがら	しま柄	抑制単語	縞柄
しまもよう	しま模様	抑制単語	縞模様
しみいっ	しみ入っ	抑制単語	沁み入っ
しみいり	しみ入り	抑制単語	沁み入り
しみいる	しみ入る	抑制単語	沁み入る
しみいる	しみ入る	抑制単語	滲み入る
しみこま	しみ込ま	抑制単語	沁み込ま
しみこま	しみ込ま	抑制単語	滲み込ま
しみこみ	しみ込み	抑制単語	沁み込み
しみこみ	しみ込み	抑制単語	滲み込み
しみこむ	しみ込む	抑制単語	沁み込む
しみこむ	しみ込む	抑制単語	滲み込む
しみこん	しみ込ん	抑制単語	沁み込ん
しみこん	しみ込ん	抑制単語	滲み込ん
しみださ	しみ出さ	抑制単語	滲み出さ
しみだし	しみ出し	抑制単語	滲み出し
しみだす	しみ出す	抑制単語	滲み出す
しみで	しみ出	抑制単語	沁み出
しみで	しみ出	抑制単語	滲み出
しみでる	しみ出る	抑制単語	滲み出る
しみわたっ	しみ渡っ	抑制単語	沁み渡っ
しみわたり	しみ渡り	抑制単語	沁み渡り
しみわたる	しみ渡る	抑制単語	沁み渡る
しめきっ	しめ切っ	抑制単語	〆切っ
しめきっ	締め切っ	抑制単語	〆切っ
しめきっ	閉め切っ	抑制単語	〆切っ
しめきら	締め切ら	抑制単語	〆切ら
しめきら	閉め切ら	抑制単語	〆切ら
しめきり	しめ切り	抑制単語	〆切り
しめきり	締め切り	抑制単語	〆切り
しめきり	締切り	抑制単語	〆切
しめきり	閉め切り	抑制単語	〆切り
しめきる	締め切る	抑制単語	〆切る
しめきる	閉め切る	抑制単語	〆切る
しめだしくらっ	締め出しくらっ	抑制単語	締め出し喰らっ
しめだしくらっ	閉め出しくらっ	抑制単語	締め出し喰らっ
しゃくしじょうぎ	しゃくし定規	抑制単語	杓子定規
しゃくにさわっ	しゃくに障っ	抑制単語	癪に障っ
しゃくにさわり	しゃくに障り	抑制単語	癪に障り
しゃくにさわる	しゃくに障る	抑制単語	癪に障る
しゃくねつ	しゃく熱	抑制単語	灼熱
しゃくねつかん	しゃく熱感	抑制単語	灼熱感
しゃけつ	しゃ血	抑制単語	瀉血
しゃじょうねらい	車上ねらい	抑制単語	車上狙い
しゃへい	遮へい	抑制単語	遮蔽
しゃべってほしい	しゃべって欲しい	抑制単語	喋って欲しい
しゃべりかけ	しゃべり掛け	抑制単語	喋り掛け
しゃべりきい	しゃべり聞い	抑制単語	喋り聞い
しゃべりたおし	しゃべり倒し	抑制単語	喋り倒し
しゃべりたおす	しゃべり倒す	抑制単語	喋り倒す
しゃべりたら	しゃべり足ら	抑制単語	喋り足ら
しゃべりたり	しゃべり足り	抑制単語	喋り足り
しゃべりつかれ	しゃべり疲れ	抑制単語	喋り疲れ
しゃべりとおし	しゃべり通し	抑制単語	喋り通し
しゃべりなれ	しゃべり慣れ	抑制単語	喋り慣れ
しゃべりほうだい	しゃべり放題	抑制単語	喋り放題
しゃれこみ	しゃれ込み	抑制単語	洒落込み
しゃれこむ	しゃれ込む	抑制単語	洒落込む
しゃれこも	しゃれ込も	抑制単語	洒落込も
しゃれこん	しゃれ込ん	抑制単語	洒落込ん
しゃれもん	しゃれ紋	抑制単語	洒落紋
しゅうえん	終えん	抑制単語	終焉
しゅうたいさらし	醜態さらし	抑制単語	醜態晒し
しゅうちしん	しゅう恥心	抑制単語	羞恥心
しゅうれん	収れん	抑制単語	収斂
しゅうれんけしょうすい	収れん化粧水	抑制単語	収斂化粧水
しゅつえん	出えん	抑制単語	出捐
しゅつろ	出ろ	抑制単語	出廬
しゅりゅうだん	手りゅう弾	抑制単語	手榴弾
しゅんかんすごい	瞬間すごい	抑制単語	瞬間凄い
しゅんこう	しゅん功	抑制単語	竣功
しゅんこう	しゅん工	抑制単語	竣工
しゅんせつせん	しゅんせつ船	抑制単語	浚渫船
しょうえび	焼えび	抑制単語	焼蝦
しょうかい	しょう戒	抑制単語	哨戒
しょうかせん	消化せん	抑制単語	消化腺
しょうがじる	しょうが汁	抑制単語	生姜汁
しょうがやき	しょうが焼き	抑制単語	生姜焼き
しょうがやき	しょうが焼き	抑制単語	生姜焼
しょうがやき	しょうが焼き	抑制単語	生姜焼き
しょうがやき	ショウガ焼き	抑制単語	生姜焼
しょうがやき	しょうが焼	抑制単語	生姜焼
しょうがやき	しょうが焼	抑制単語	生姜焼き
しょうこんたくましい	商魂たくましい	抑制単語	商魂逞しい
しょうこんたくましく	商魂たくましく	抑制単語	商魂逞しく
しょうごごろ	正午ごろ	抑制単語	正午頃
しょうじきうっとうしい	正直うっとうしい	抑制単語	正直鬱陶しい
しょうじきうらやましい	正直うらやましい	抑制単語	正直羨ましい
しょうじきうらやましかっ	正直うらやましかっ	抑制単語	正直羨ましかっ
しょうじきうらやましく	正直うらやましく	抑制単語	正直羨ましく
しょうじきうれしい	正直うれしい	抑制単語	正直嬉しい
しょうじきうれしかっ	正直うれしかっ	抑制単語	正直嬉しかっ
しょうじきうれしく	正直うれしく	抑制単語	正直嬉しく
しょうじきすごい	正直すごい	抑制単語	正直凄い
しょうじきすごく	正直すごく	抑制単語	正直凄く
しょうじきなめ	正直なめ	抑制単語	正直舐め
しょうじきもったいない	正直もったいない	抑制単語	正直勿体ない
しょうじきもったいない	正直もったいない	抑制単語	正直勿体無い
しょうじきものすごく	正直ものすごく	抑制単語	正直物凄く
しょうどんぶり	小どんぶり	抑制単語	小丼ぶり
しょうはい	賞はい	抑制単語	賞牌
しょうふろしき	小ふろしき	抑制単語	小風呂敷
しょうぶえん	しょうぶ園	抑制単語	菖蒲園
しょうぶゆ	しょうぶ湯	抑制単語	菖蒲湯
しょうへい	招へい	抑制単語	招聘
しょうまわり	小まわり	抑制単語	小廻り
しょうまんじゅう	焼まんじゅう	抑制単語	焼饅頭
しょうゆ	しょう油	抑制単語	醤油
しょうゆ	しょう油	抑制単語	醬油
しょうゆあじ	しょうゆ味	抑制単語	醤油味
しょうゆおおさじ	しょうゆ大さじ	抑制単語	醤油大さじ
しょうゆこさじ	しょうゆ小さじ	抑制単語	醤油小さじ
しょうゆづけ	しょうゆ漬け	抑制単語	醤油漬け
しょうゆづけ	しょうゆ漬け	抑制単語	醤油漬
しょうゆづけ	しょうゆ漬け	抑制単語	醤油漬け
しょうゆらーめん	しょう油ラーメン	抑制単語	醤油ラーメン
しょうらいすごい	将来すごい	抑制単語	将来凄い
しょくだい	しょく台	抑制単語	燭台
しょくどうがん	食道がん	抑制単語	食道癌
しょせん	所せん	抑制単語	所詮
しょとう	しょ糖	抑制単語	蔗糖
しょにちぶたいあいさつ	初日舞台あいさつ	抑制単語	初日舞台挨拶
しょほうせん	処方せん	抑制単語	処方箋
しりあいにもらっ	知り合いにもらっ	抑制単語	知り合いに貰っ
しりあがり	しり上がり	抑制単語	尻上がり
しりあがり	しり上がり	抑制単語	尻上り
しりごみ	しり込み	抑制単語	尻込み
しりめ	しり目	抑制単語	尻目
しれつ	し烈	抑制単語	熾烈
しろあん	白あん	抑制単語	白餡
しろかき	代かき	抑制単語	代掻き
しろくま	白くま	抑制単語	白熊
しろごま	白ごま	抑制単語	白胡麻
しろねぎ	白ねぎ	抑制単語	白葱
しろみそ	白みそ	抑制単語	白味噌
しろむく	白むく	抑制単語	白無垢
しろめ	白め	抑制単語	白鑞
しろめをむい	白目をむい	抑制単語	白目を剥い
しろめをむき	白目をむき	抑制単語	白目を剥き
しろめをむく	白目をむく	抑制単語	白目を剥く
しんかや	新かや	抑制単語	新榧
しんかん	震かん	抑制単語	震撼
しんきんこうそく	心筋こうそく	抑制単語	心筋梗塞
しんけいをとがらせ	神経をとがらせ	抑制単語	神経を尖らせ
しんけいをとがらせる	神経をとがらせる	抑制単語	神経を尖らせる
しんこうがん	進行がん	抑制単語	進行癌
しんごぼう	新ごぼう	抑制単語	新牛蒡
しんしゃく	しん酌	抑制単語	斟酌
しんしゅつ	しん出	抑制単語	滲出
しんしょう	新しょう	抑制単語	新梢
しんしょうが	新しょうが	抑制単語	新生姜
しんすし	新寿し	抑制単語	新鮨
しんずし	新寿し	抑制単語	新逗子
しんずし	新寿し	抑制単語	新鮨
しんせき	親せき	抑制単語	親戚
しんそこうらやましい	心底うらやましい	抑制単語	心底羨ましい
しんそば	新そば	抑制単語	新蕎麦
しんたけのこ	新たけのこ	抑制単語	新筍
しんたけのこ	新竹の子	抑制単語	新筍
しんたまねぎ	新たまねぎ	抑制単語	新玉葱
しんたまねぎ	新玉ねぎ	抑制単語	新玉葱
しんちゅう	真ちゅう	抑制単語	真鍮
しんちゅうせい	真ちゅう製	抑制単語	真鍮製
しんちょく	進ちょく	抑制単語	進捗
しんちょくりつ	進ちょく率	抑制単語	進捗率
しんとう	震とう	抑制単語	震盪
しんのり	新のり	抑制単語	新海苔
しんぴょう	信ぴょう	抑制単語	信憑
しんぴょうせい	信ぴょう性	抑制単語	信憑性
しんぼく	親ぼく	抑制単語	親睦
しんらつ	辛らつ	抑制単語	辛辣
しんれんこん	新れんこん	抑制単語	新蓮根
じかんすごい	時間すごい	抑制単語	時間凄い
じかんすごく	時間すごく	抑制単語	時間凄く
じかんつぶし	時間つぶし	抑制単語	時間潰し
じかんもったいない	時間もったいない	抑制単語	時間勿体ない
じかんもったいない	時間もったいない	抑制単語	時間勿体無い
じきうれしい	時期うれしい	抑制単語	時期嬉しい
じしんすごい	自身すごい	抑制単語	自身凄い
じしんすごかっ	地震すごかっ	抑制単語	地震凄かっ
じしんすごく	自身すごく	抑制単語	自身凄く
じじ	自じ	抑制単語	自恃
じっさいすごい	実際すごい	抑制単語	実際凄い
じっさいすごかっ	実際すごかっ	抑制単語	実際凄かっ
じっさいすごく	実際すごく	抑制単語	実際凄く
じっさいものすごい	実際ものすごい	抑制単語	実際物凄い
じっさいものすごく	実際ものすごく	抑制単語	実際物凄く
じてんしゃこぎ	自転車こぎ	抑制単語	自転車漕ぎ
じびいんこう	耳鼻いんこう	抑制単語	耳鼻咽喉
じぶんあて	自分あて	抑制単語	自分宛て
じぶんすごい	自分すごい	抑制単語	自分凄い
じまつげ	自まつげ	抑制単語	自睫毛
じゃこう	じゃ香	抑制単語	麝香
じゅういちがつごろ	十一月ごろ	抑制単語	11月頃
じゅういちがつごろ	十一月ごろ	抑制単語	十一月頃
じゅうがつごろ	十月ごろ	抑制単語	10月頃
じゅうがつごろ	十月ごろ	抑制単語	十月頃
じゅうそ	重そ	抑制単語	重祚
じゅうてん	充てん	抑制単語	充塡
じゅうてん	充てん	抑制単語	充填
じゅうにがつごろ	十二月ごろ	抑制単語	12月頃
じゅうにがつごろ	十二月ごろ	抑制単語	十二月頃
じゅうぶんうれしい	十分うれしい	抑制単語	充分嬉しい
じゅうぶんうれしい	十分うれしい	抑制単語	十分嬉しい
じゅうぶんきれい	十分きれい	抑制単語	十分綺麗
じゅうぶんすごい	充分すごい	抑制単語	充分凄い
じゅうぶんすごい	充分すごい	抑制単語	十分凄い
じゅうぶんすごい	十分すごい	抑制単語	充分凄い
じゅうぶんすごい	十分すごい	抑制単語	十分凄い
じゅずつなぎ	数珠つなぎ	抑制単語	数珠繋ぎ
じゅもん	じゅ文	抑制単語	呪文
じゅんせっけん	純せっけん	抑制単語	純石鹸
じゅんせっけん	純石けん	抑制単語	純石鹸
じゅんせっけんぶん	純石けん分	抑制単語	純石鹸分
じゅんら	巡ら	抑制単語	巡邏
じょうし	上し	抑制単語	上梓
じょうとう	常とう	抑制単語	常套
じょうにほだされ	情にほだされ	抑制単語	情に絆され
じょうは	条は	抑制単語	条播
じょうほうろうえい	情報漏えい	抑制単語	情報漏洩
じょうほうろうえいたいさく	情報漏えい対策	抑制単語	情報漏洩対策
じょうらん	じょう乱	抑制単語	擾乱
じんせいかけ	人生かけ	抑制単語	人生賭け
じんぞう	じん臓	抑制単語	腎臓
じんたい	じん帯	抑制単語	靭帯
じんたい	じん帯	抑制単語	靱帯
じんたいだんれつ	じん帯断裂	抑制単語	靭帯断裂
じんたいだんれつ	じん帯断裂	抑制単語	靱帯断裂
じんふぜん	じん不全	抑制単語	腎不全
すいさん	炊さん	抑制単語	炊爨
すいしゅ	水しゅ	抑制単語	水腫
すいせい	すい星	抑制単語	彗星
すいぜん	垂ぜん	抑制単語	垂涎
すいぞう	すい臓	抑制単語	膵臓
すいぞうがん	すい臓ガン	抑制単語	膵臓ガン
すいぞうがん	すい臓ガン	抑制単語	膵臓癌
すいぞうがん	すい臓がん	抑制単語	膵臓がん
すいぞうがん	すい臓がん	抑制単語	膵臓ガン
すいぞうがん	すい臓がん	抑制単語	膵臓癌
すいもあまいもかみわけ	酸いも甘いもかみ分け	抑制単語	酸いも甘いも噛み分け
すがすがしいあさ	すがすがしい朝	抑制単語	清々しい朝
すがすがしいきぶん	すがすがしい気分	抑制単語	清々しい気分
すがすがしいきもち	すがすがしい気持ち	抑制単語	清々しい気持ち
すがりつい	すがり付い	抑制単語	縋り付い
すがりつき	すがり付き	抑制単語	縋り付き
すがりつく	すがり付く	抑制単語	縋り付く
すきけ	すき毛	抑制単語	梳き毛
すきこま	すき込ま	抑制単語	漉き込ま
すきこま	すき込ま	抑制単語	鋤き込ま
すきこみ	すき込み	抑制単語	漉き込み
すきこみ	すき込み	抑制単語	鋤き込み
すきこむ	すき込む	抑制単語	漉き込む
すきこむ	すき込む	抑制単語	鋤き込む
すきこん	すき込ん	抑制単語	漉き込ん
すきこん	すき込ん	抑制単語	鋤き込ん
すきとっ	すき取っ	抑制単語	漉き取っ
すきとり	すき取り	抑制単語	漉き取り
すきま	すき間	抑制単語	隙間
すきま	空き間	抑制単語	隙間
すきま	透き間	抑制単語	隙間
すきまかぜ	すきま風	抑制単語	隙間風
すきまかぜ	すき間風	抑制単語	隙間風
すきましゅうのう	すきま収納	抑制単語	隙間収納
すきましゅうのう	すき間収納	抑制単語	隙間収納
すきまじかん	すきま時間	抑制単語	隙間時間
すきまなく	すき間なく	抑制単語	隙間なく
すくいあげ	すくい上げ	抑制単語	掬い上げ
すくいあげ	すくい上げ	抑制単語	掬い上げ
すくいあげる	すくい上げる	抑制単語	掬い上げる
すくいうち	すくい打ち	抑制単語	掬い打ち
すくいとっ	すくい取っ	抑制単語	掬い取っ
すくいとら	すくい取ら	抑制単語	掬い取ら
すくいとり	すくい取り	抑制単語	掬い取り
すくいとる	すくい取る	抑制単語	掬い取る
すくいとれ	すくい取れ	抑制単語	掬い取れ
すくいとれる	すくい取れる	抑制単語	掬い取れる
すくいなげ	すくい投げ	抑制単語	掬い投げ
すくいぬい	すくい縫い	抑制単語	掬い縫い
すくみあがっ	すくみ上がっ	抑制単語	竦み上がっ
すくみあがる	すくみ上がる	抑制単語	竦み上がる
すこしあやしい	少しあやしい	抑制単語	少し妖しい
すこしうさんくさい	少しうさんくさい	抑制単語	少し胡散臭い
すこしうっとうしい	少しうっとうしい	抑制単語	少し鬱陶しい
すこしうっとうしく	少しうっとうしく	抑制単語	少し鬱陶しく
すこしうらやまし	少しうらやまし	抑制単語	少し羨まし
すこしうらやましい	少しうらやましい	抑制単語	少し羨ましい
すこしうらやましかっ	少しうらやましかっ	抑制単語	少し羨ましかっ
すこしうらやましく	少しうらやましく	抑制単語	少し羨ましく
すこしうるさい	少しうるさい	抑制単語	少し五月蝿い
すこしうるさい	少しうるさい	抑制単語	少し五月蠅い
すこしうれし	少しうれし	抑制単語	少し嬉し
すこしうれしい	少しうれしい	抑制単語	少し嬉しい
すこしうれしかっ	少しうれしかっ	抑制単語	少し嬉しかっ
すこしうれしく	少しうれしく	抑制単語	少し嬉しく
すこしかゆ	少しかゆ	抑制単語	少し痒
すこしかゆい	少しかゆい	抑制単語	少し痒い
すこしかゆく	少しかゆく	抑制単語	少し痒く
すこしさびし	少しさびし	抑制単語	少し淋し
すこしさびしい	少しさびしい	抑制単語	少し淋しい
すこしさびしかっ	少しさびしかっ	抑制単語	少し淋しかっ
すこしさびしく	少しさびしく	抑制単語	少し淋しく
すこしさみし	少しさみし	抑制単語	少し淋し
すこしさみしい	少しさみしい	抑制単語	少し淋しい
すこしさみしく	少しさみしく	抑制単語	少し淋しく
すこしすごい	少しすごい	抑制単語	少し凄い
すこしずうずうしい	少しずうずうしい	抑制単語	少し図々しい
すこしたくましく	少したくましく	抑制単語	少し逞しく
すこしはがゆい	少し歯がゆい	抑制単語	少し歯痒い
すこしほこりっぽい	少しほこりっぽい	抑制単語	少し埃っぽい
すこしまぶし	少しまぶし	抑制単語	少し眩し
すこしまぶしい	少しまぶしい	抑制単語	少し眩しい
すこしまぶしく	少しまぶしく	抑制単語	少し眩しく
すこしもったいない	少しもったいない	抑制単語	少し勿体ない
すこしもったいない	少しもったいない	抑制単語	少し勿体無い
すこしもったいなかっ	少しもったいなかっ	抑制単語	少し勿体なかっ
すこしもったいなかっ	少しもったいなかっ	抑制単語	少し勿体無かっ
すこしもったいなく	少しもったいなく	抑制単語	少し勿体なく
すこしもったいなく	少しもったいなく	抑制単語	少し勿体無く
すこしもろい	少しもろい	抑制単語	少し脆い
すこしもろく	少しもろく	抑制単語	少し脆く
すごいあつ	すごい圧	抑制単語	凄い圧
すごいあめ	すごい雨	抑制単語	凄い雨
すごいいきおい	すごい勢い	抑制単語	凄い勢い
すごいいや	すごい嫌	抑制単語	凄い嫌
すごいいわかん	すごい違和感	抑制単語	凄い違和感
すごいえいが	すごい映画	抑制単語	凄い映画
すごいおと	すごい音	抑制単語	凄い音
すごいかお	すごい顔	抑制単語	凄い顔
すごいかず	すごい数	抑制単語	凄い数
すごいかぜ	すごい風	抑制単語	凄い風
すごいかた	すごい方	抑制単語	凄い方
すごいきんがく	すごい金額	抑制単語	凄い金額
すごいぎじゅつ	すごい技術	抑制単語	凄い技術
すごいぎょうれつ	すごい行列	抑制単語	凄い行列
すごいくるま	すごい車	抑制単語	凄い車
すごいぐい	すごい食い	抑制単語	凄い食い
すごいけい	すごい系	抑制単語	凄い系
すごいこうか	すごい効果	抑制単語	凄い効果
すごいごのみ	すごい好み	抑制単語	凄い好み
すごいさいのう	すごい才能	抑制単語	凄い才能
すごいさくひん	すごい作品	抑制単語	凄い作品
すごいしあい	すごい試合	抑制単語	凄い試合
すごいじかん	すごい時間	抑制単語	凄い時間
すごいじだい	すごい時代	抑制単語	凄い時代
すごいじょうたい	すごい状態	抑制単語	凄い状態
すごいじょうほう	すごい情報	抑制単語	凄い情報
すごいすき	すごい好き	抑制単語	凄い好き
すごいせかい	すごい世界	抑制単語	凄い世界
すごいせんしゅ	すごい選手	抑制単語	凄い選手
すごいそんざい	すごい存在	抑制単語	凄い存在
すごいちから	すごい力	抑制単語	凄い力
すごいてき	すごい的	抑制単語	凄い的
すごいなまえ	すごい名前	抑制単語	凄い名前
すごいにんき	すごい人気	抑制単語	凄い人気
すごいにんずう	すごい人数	抑制単語	凄い人数
すごいはくりょく	すごい迫力	抑制単語	凄い迫力
すごいはなし	すごい話	抑制単語	凄い話
すごいはやさ	すごい速さ	抑制単語	凄い速さ
すごいひと	すごい人	抑制単語	凄い人
すごいひとで	すごい人出	抑制単語	凄い人出
すごいびじん	すごい美人	抑制単語	凄い美人
すごいべんり	すごい便利	抑制単語	凄い便利
すごいやっこ	すごい奴	抑制単語	凄い奴
すごいゆき	すごい雪	抑制単語	凄い雪
すごいらく	すごい楽	抑制単語	凄い楽
すごいりょう	すごい量	抑制単語	凄い量
すごうで	すご腕	抑制単語	凄腕
すごくかん	すごく間	抑制単語	凄く間
すごくごのみ	すごく好み	抑制単語	凄く好み
すごくてき	すごく的	抑制単語	凄く的
すごみ	すご味	抑制単語	凄味
すごもり	巣ごもり	抑制単語	巣篭り
すごもり	巣ごもり	抑制単語	巣籠もり
すごもり	巣ごもり	抑制単語	巣籠り
すごわざ	すご技	抑制単語	凄技
すしずめ	すし詰め	抑制単語	鮨詰
すしずめ	すし詰め	抑制単語	鮨詰め
すしづめ	すし詰め	抑制単語	鮨詰
すしづめ	すし詰め	抑制単語	鮨詰め
すしどころ	すし処	抑制単語	鮨処
すしめし	すし飯	抑制単語	鮨飯
すすりあげ	すすり上げ	抑制単語	啜り上げ
すすりあげる	すすり上げる	抑制単語	啜り上げる
すすりこみ	すすり込み	抑制単語	啜り込み
すすりこむ	すすり込む	抑制単語	啜り込む
すすりこん	すすり込ん	抑制単語	啜り込ん
すすりない	すすり泣い	抑制単語	啜り泣い
すすりなき	すすり泣き	抑制単語	啜り泣き
すすりなく	すすり泣く	抑制単語	啜り泣く
すずりばこ	すずり箱	抑制単語	硯箱
すそあげ	すそ上げ	抑制単語	裾上げ
すその	すそ野	抑制単語	裾野
すそまわり	すそ周り	抑制単語	裾周り
すだこ	酢だこ	抑制単語	酢蛸
すなぼこり	砂ぼこり	抑制単語	砂埃
すなをかむ	砂をかむ	抑制単語	砂を噛む
すなをかん	砂をかん	抑制単語	砂を噛ん
すねあて	すね当て	抑制単語	脛当て
すねあて	すね当て	抑制単語	臑当
すねにきずもつ	すねに傷持つ	抑制単語	脛に傷持つ
すねにきずをもつ	すねに傷を持つ	抑制単語	脛に傷を持つ
すばらしい	素晴らしい	抑制単語	素薔薇しい
すべてまとめ	全てまとめ	抑制単語	全て纏め
すまき	す巻き	抑制単語	簀巻
すまき	す巻き	抑制単語	簀巻き
すみそ	酢みそ	抑制単語	酢味噌
すみそあえ	酢みそ和え	抑制単語	酢味噌和え
すみつい	住みつい	抑制単語	住み憑い
すみつく	住みつく	抑制単語	住み憑く
すみれいろ	すみれ色	抑制単語	菫色
すみわけ	すみ分け	抑制単語	棲み分け
すみわけ	すみ分け	抑制単語	棲み分け
すみわける	すみ分ける	抑制単語	棲み分ける
すりあし	すり足	抑制単語	摺足
すりあわせ	すり合せ	抑制単語	摺り合せ
すりあわせ	刷り合わせ	抑制単語	摺り合せ
すりあわせ	擦り合わせ	抑制単語	摺り合せ
すりあわせ	磨り合わせ	抑制単語	摺り合せ
すりあわせ	すり合わせ	抑制単語	摺り合わせ
すりあわせし	すり合わせし	抑制単語	摺り合わせし
すりあわせる	すり合わせる	抑制単語	摺り合わせる
すりおろし	すり下ろし	抑制単語	摺り下ろし
すりおろし	すり下ろし	抑制単語	擂り下ろし
すりおろす	すり下ろす	抑制単語	摺り下ろす
すりこぎ	すりこ木	抑制単語	擂り粉木
すりこぎ	すりこ木	抑制単語	擂粉木
すりこま	すり込ま	抑制単語	摺り込ま
すりこみ	すり込み	抑制単語	摺り込み
すりこみもん	すりこみ紋	抑制単語	摺り込み紋
すりこむ	すり込む	抑制単語	摺り込む
すりこん	すり込ん	抑制単語	摺り込ん
すりつぶし	擦りつぶし	抑制単語	擦り潰し
すりつぶし	磨りつぶし	抑制単語	磨り潰し
すりぬけ	すり抜け	抑制単語	摺り抜け
すりばち	すり鉢	抑制単語	擂り鉢
すりばち	すり鉢	抑制単語	擂鉢
すりむい	擦りむい	抑制単語	擦り剥い
すりむき	擦りむき	抑制単語	擦り剥き
すりむく	擦りむく	抑制単語	擦り剥く
すりむけ	擦りむけ	抑制単語	擦り剥け
すりむける	擦りむける	抑制単語	擦り剥ける
すりよせ	すり寄せ	抑制単語	摺り寄せ
すりよせる	すり寄せる	抑制単語	摺り寄せる
すりよっ	すり寄っ	抑制単語	摺り寄っ
すわりこん	すわり込ん	抑制単語	坐り込ん
ずいぶんすごい	随分すごい	抑制単語	随分凄い
ずいぶんたくましく	随分たくましく	抑制単語	随分逞しく
ずがいこつ	頭がい骨	抑制単語	頭蓋骨
ずだぶくろ	ずだ袋	抑制単語	頭陀袋
ずるかしこい	ずる賢い	抑制単語	狡賢い
ずるかしこく	ずる賢く	抑制単語	狡賢く
ずるかしこさ	ずる賢さ	抑制単語	狡賢さ
ずるがしこい	ずる賢い	抑制単語	狡賢い
ずるがしこく	ずる賢く	抑制単語	狡賢く
ずるがしこさ	ずる賢さ	抑制単語	狡賢さ
せいかん	精かん	抑制単語	精悍
せいきごろ	世紀ごろ	抑制単語	世紀頃
せいそ	清そ	抑制単語	清楚
せいぞろい	勢ぞろい	抑制単語	勢揃い
せいとん	整とん	抑制単語	整頓
せいひつ	静ひつ	抑制単語	静謐
せかいいちすごい	世界一すごい	抑制単語	世界一凄い
せきこみ	せき込み	抑制単語	咳き込み
せきこみ	せき込み	抑制単語	咳込み
せきこむ	せき込む	抑制単語	咳き込む
せきこむ	せき込む	抑制単語	咳込む
せきこむ	急き込む	抑制単語	咳込む
せきこん	せき込ん	抑制単語	咳き込ん
せきこん	せき込ん	抑制単語	咳込ん
せきこん	急き込ん	抑制単語	咳込ん
せきずい	せき髄	抑制単語	脊髄
せきちゅう	せき柱	抑制単語	脊柱
せきついどうぶつ	せきつい動物	抑制単語	脊椎動物
せきとめ	せき止め	抑制単語	堰き止め
せきとめ	せき止め	抑制単語	塞き止め
せきとめ	せき止め	抑制単語	堰き止め
せきとめ	せき止め	抑制単語	塞き止め
せきとめる	せき止める	抑制単語	堰き止める
せきとめる	せき止める	抑制単語	塞き止める
せっけん	石けん	抑制単語	石鹸
せっけん	石けん	抑制単語	石鹼
せっけんおき	石けん置き	抑制単語	石鹸置き
せっけんかす	石けんカス	抑制単語	石鹸カス
せっけんしゃんぷー	石けんシャンプー	抑制単語	石鹸シャンプー
せっけんすい	石けん水	抑制単語	石鹸水
せっけんづくり	石けん作り	抑制単語	石鹸作り
せっこう	石こう	抑制単語	石膏
せっこうぼーど	石こうボード	抑制単語	石膏ボード
せびれ	背びれ	抑制単語	背鰭
せめあぐん	攻めあぐん	抑制単語	攻め倦ん
せめがい	攻めがい	抑制単語	攻め甲斐
せめさいなま	責めさいなま	抑制単語	責め苛ま
せめさいなむ	責めさいなむ	抑制単語	責め苛む
せんえつ	せん越	抑制単語	僭越
せんかた	せん方	抑制単語	詮方
せんがんせっけん	洗顔石けん	抑制単語	洗顔石鹸
せんこう	せん光	抑制単語	閃光
せんこう	せん孔	抑制単語	穿孔
せんじつうれしい	先日うれしい	抑制単語	先日嬉しい
せんそ	践そ	抑制単語	践祚
せんだん	せん断	抑制単語	剪断
せんちゃ	せん茶	抑制単語	煎茶
せんつう	せん痛	抑制単語	疝痛
せんてい	せん定	抑制単語	剪定
せんどう	せん動	抑制単語	煽動
せんどう	せん動	抑制単語	顫動
せんない	せん無い	抑制単語	詮無い
せんば	せん馬	抑制単語	騙馬
せんばずる	千羽づる	抑制単語	千羽鶴
せんばづる	千羽づる	抑制単語	千羽鶴
せんぶ	宣ぶ	抑制単語	宣撫
せんべいぶとん	せんべい布団	抑制単語	煎餅布団
せんべいや	せんべい屋	抑制単語	煎餅屋
せんべつ	せん別	抑制単語	餞別
せんべん	先べん	抑制単語	先鞭
せんぼう	せん望	抑制単語	羨望
せんぽう	先ぽう	抑制単語	先鋒
せんめつ	せん滅	抑制単語	殲滅
せんもう	せん妄	抑制単語	譫妄
せんもう	せん毛	抑制単語	剪毛
せんりつ	戦りつ	抑制単語	戦慄
ぜいげん	ぜい言	抑制単語	贅言
ぜいじゃく	ぜい弱	抑制単語	脆弱
ぜいじゃく	ぜい弱	抑制単語	脆弱
ぜいじゃくせい	ぜい弱性	抑制単語	脆弱性
ぜいたく	ぜい沢	抑制単語	贅沢
ぜいたくひん	ぜいたく品	抑制単語	贅沢品
ぜいにく	ぜい肉	抑制単語	贅肉
ぜったいうれしい	絶対うれしい	抑制単語	絶対嬉しい
ぜったいすごい	絶対すごい	抑制単語	絶対凄い
ぜつがん	舌がん	抑制単語	舌癌
ぜんいんすごい	全員すごい	抑制単語	全員凄い
ぜんかご	前かご	抑制単語	前籠
ぜんかんそろえ	全巻そろえ	抑制単語	全巻揃え
ぜんがゆ	全がゆ	抑制単語	全粥
ぜんがん	前がん	抑制単語	前癌
ぜんしんかゆい	全身かゆい	抑制単語	全身痒い
ぜんしんかゆく	全身かゆく	抑制単語	全身痒く
ぜんしんけんたいかん	全身けん怠感	抑制単語	全身倦怠感
ぜんすそ	前すそ	抑制単語	前裾
ぜんぜんうらやましい	全然うらやましい	抑制単語	全然羨ましい
ぜんぜんうらやましく	全然うらやましく	抑制単語	全然羨ましく
ぜんぜんうれし	全然うれし	抑制単語	全然嬉し
ぜんぜんうれしい	全然うれしい	抑制単語	全然嬉しい
ぜんぜんうれしく	全然うれしく	抑制単語	全然嬉しく
ぜんぜんかゆく	全然かゆく	抑制単語	全然痒く
ぜんぜんさびしく	全然さびしく	抑制単語	全然淋しく
ぜんぜんすごい	全然すごい	抑制単語	全然凄い
ぜんぜんすごかっ	全然すごかっ	抑制単語	全然凄かっ
ぜんぜんすごく	全然すごく	抑制単語	全然凄く
ぜんぜんまぶしく	全然まぶしく	抑制単語	全然眩しく
ぜんそく	ぜん息	抑制単語	喘息
ぜんどう	ぜん動	抑制単語	蠕動
ぜんどううんどう	ぜん動運動	抑制単語	蠕動運動
ぜんにゅうがん	前乳がん	抑制単語	前乳癌
ぜんはんごろ	前半ごろ	抑制単語	前半頃
ぜんぶすごい	全部すごい	抑制単語	全部凄い
ぜんぶそろい	全部そろい	抑制単語	全部揃い
ぜんぶそろえ	全部そろえ	抑制単語	全部揃え
ぜんぶはがし	全部はがし	抑制単語	全部剥がし
ぜんぼう	全ぼう	抑制単語	全貌
ぜんもも	前もも	抑制単語	前腿
ぜんりつせん	前立せん	抑制単語	前立腺
ぜんろう	全ろう	抑制単語	全聾
そうかい	そう快	抑制単語	爽快
そうかいかん	そう快感	抑制単語	爽快感
そうかいかん	そう快感	抑制単語	爽快館
そうきだいちょうがん	早期大腸がん	抑制単語	早期大腸癌
そうくつ	巣くつ	抑制単語	巣窟
そうしん	そう身	抑制単語	痩身
そうせい	そう生	抑制単語	叢生
そうせい	そう生	抑制単語	簇生
そうたんぱく	総たんぱく	抑制単語	総蛋白
そうだ	操だ	抑制単語	操舵
そうてん	装てん	抑制単語	装塡
そうてん	装てん	抑制単語	装填
そうとううれしい	相当うれしい	抑制単語	相当嬉しい
そうとううれしかっ	相当うれしかっ	抑制単語	相当嬉しかっ
そうとうかゆい	相当かゆい	抑制単語	相当痒い
そうとうすごい	相当すごい	抑制単語	相当凄い
そうとうすごい	相当すごい	抑制単語	相当凄い
そうとうすごかっ	相当すごかっ	抑制単語	相当凄かっ
そうとうすごく	相当すごく	抑制単語	相当凄く
そうひのき	総ひのき	抑制単語	総桧
そうひのき	総ひのき	抑制単語	総檜
そうびそろえ	装備そろえ	抑制単語	装備揃え
そうびょう	そう病	抑制単語	躁病
そうらん	総らん	抑制単語	総攬
そくが	側が	抑制単語	側臥
そくせきめん	即席めん	抑制単語	即席麺
そこう	そ行	抑制単語	溯行
そこう	そ行	抑制単語	遡行
そこひ	底ひ	抑制単語	底翳
そこびきあみ	底引き網	抑制単語	底曳網
そさい	そ菜	抑制単語	蔬菜
そじょう	そ上	抑制単語	遡上
そせい	そ生	抑制単語	蘇生
そだてがい	育てがい	抑制単語	育て甲斐
そでぐち	そで口	抑制単語	袖口
そでたけ	そで丈	抑制単語	袖丈
そばがら	そば殻	抑制単語	蕎麦殻
そばきり	そば切り	抑制単語	蕎麦切り
そばこ	そば粉	抑制単語	蕎麦粉
そばたべ	そば食べ	抑制単語	蕎麦食べ
そばゆ	そば湯	抑制単語	蕎麦湯
そびえたち	そびえ立ち	抑制単語	聳え立ち
そびえたっ	そびえ立っ	抑制単語	聳え立っ
そびえたつ	そびえ建つ	抑制単語	聳え建つ
そびえたつ	そびえ立つ	抑制単語	聳え立つ
そりおとし	そり落とし	抑制単語	剃り落し
そりおとし	そり落とし	抑制単語	剃り落とし
そりこみ	そり込み	抑制単語	剃り込み
そりのこし	そり残し	抑制単語	剃り残し
それほどすごい	それ程すごい	抑制単語	それ程凄い
そろいしだい	そろい次第	抑制単語	揃い次第
そろいしだい	そろい次第	抑制単語	揃い次第
そろいぶみ	そろい踏み	抑制単語	揃い踏み
そろか	粗ろ過	抑制単語	粗濾過
そんしょく	そん色	抑制単語	遜色
そんしょくない	そん色ない	抑制単語	遜色ない
たいこをたたい	太鼓をたたい	抑制単語	太鼓を叩い
たいこをたたか	太鼓をたたか	抑制単語	太鼓を叩か
たいこをたたき	太鼓をたたき	抑制単語	太鼓を叩き
たいこをたたく	太鼓をたたく	抑制単語	太鼓を叩く
たいしょく	たい色	抑制単語	褪色
たいじ	対じ	抑制単語	対峙
たいせき	たい積	抑制単語	堆積
たいとう	たい頭	抑制単語	擡頭
たいはい	たい廃	抑制単語	頽廃
たいひ	たい肥	抑制単語	堆肥
たいへんうらやましい	大変うらやましい	抑制単語	大変羨ましい
たいへんうらやましく	大変うらやましく	抑制単語	大変羨ましく
たいへんうれし	大変うれし	抑制単語	大変嬉し
たいへんうれしい	大変うれしい	抑制単語	大変嬉しい
たいへんうれしかっ	大変うれしかっ	抑制単語	大変嬉しかっ
たいへんうれしく	大変うれしく	抑制単語	大変嬉しく
たいへんうれしゅう	大変うれしゅう	抑制単語	大変嬉しゅう
たいへんきれい	大変きれい	抑制単語	大変綺麗
たいへんもったいない	大変もったいない	抑制単語	大変勿体ない
たいへんもったいない	大変もったいない	抑制単語	大変勿体無い
たいやきや	たいやき屋	抑制単語	鯛焼き屋
たえしのい	耐えしのい	抑制単語	耐え凌い
たえしのぎ	耐えしのぎ	抑制単語	耐え凌ぎ
たえしのぐ	耐えしのぐ	抑制単語	耐え凌ぐ
たかいびき	高いびき	抑制単語	高鼾
たからくじ	宝くじ	抑制単語	宝籤
たきあわせ	炊き合わせ	抑制単語	焚き合せ
たきつぼ	滝つぼ	抑制単語	滝壷
たきつぼ	滝つぼ	抑制単語	滝壺
たきにわたっ	多岐にわたっ	抑制単語	多岐に亘っ
たきにわたり	多岐にわたり	抑制単語	多岐に亘り
たきにわたる	多岐にわたる	抑制単語	多岐に亘る
たきび	たき火	抑制単語	焚き火
たきび	たき火	抑制単語	焚火
たきもの	たき物	抑制単語	焚物
たくさんとりそろえ	たくさん取りそろえ	抑制単語	たくさん取り揃え
たくさんとりそろえ	たくさん取りそろえ	抑制単語	沢山取り揃え
たけかご	竹かご	抑制単語	竹籠
たけざお	竹ざお	抑制単語	竹竿
たけとんぼ	竹とんぼ	抑制単語	竹蜻蛉
たけのこごはん	たけのこご飯	抑制単語	筍ご飯
たけべら	竹べら	抑制単語	竹篦
たけやぶ	竹やぶ	抑制単語	竹薮
たけやぶ	竹やぶ	抑制単語	竹藪
たけやり	竹やり	抑制単語	竹槍
たこのき	たこの木	抑制単語	蛸の木
たすうそろえ	多数そろえ	抑制単語	多数揃え
たすうとりそろえ	多数取りそろえ	抑制単語	多数取り揃え
たずなさばき	手綱さばき	抑制単語	手綱捌き
たたかいがい	戦いがい	抑制単語	戦い甲斐
たたかいにおい	戦いにおい	抑制単語	戦いに於い
たたきあげ	たたき上げ	抑制単語	叩き上げ
たたきあげ	たたき上げ	抑制単語	叩き上げ
たたきあげる	たたき上げる	抑制単語	叩き上げる
たたきあらい	たたき洗い	抑制単語	叩き洗い
たたきあわせ	たたき合わせ	抑制単語	叩き合わせ
たたきあわせる	たたき合わせる	抑制単語	叩き合わせる
たたきいれ	たたき入れ	抑制単語	叩き入れ
たたきうっ	たたき売っ	抑制単語	叩き売っ
たたきうめ	たたき梅	抑制単語	叩き梅
たたきうら	たたき売ら	抑制単語	叩き売ら
たたきうり	たたき売り	抑制単語	叩き売り
たたきうりし	たたき売りし	抑制単語	叩き売りし
たたきうる	たたき売る	抑制単語	叩き売る
たたきおこさ	たたき起こさ	抑制単語	叩き起こさ
たたきおこさ	たたき起こさ	抑制単語	叩き起さ
たたきおこし	たたき起こし	抑制単語	叩き起こし
たたきおこし	たたき起こし	抑制単語	叩き起し
たたきおこし	たたき起し	抑制単語	叩き起こし
たたきおこし	たたき起し	抑制単語	叩き起し
たたきおこす	たたき起こす	抑制単語	叩き起こす
たたきおこす	たたき起こす	抑制単語	叩き起す
たたきおっ	たたき折っ	抑制単語	叩き折っ
たたきおとさ	たたき落とさ	抑制単語	叩き落さ
たたきおとさ	たたき落とさ	抑制単語	叩き落とさ
たたきおとし	たたき落とし	抑制単語	叩き落し
たたきおとし	たたき落とし	抑制単語	叩き落とし
たたきおとす	たたき落とす	抑制単語	叩き落す
たたきおとす	たたき落とす	抑制単語	叩き落とす
たたきおとせる	たたき落とせる	抑制単語	叩き落とせる
たたきおる	たたき折る	抑制単語	叩き折る
たたきかえさ	たたき返さ	抑制単語	叩き返さ
たたきかえし	たたき返し	抑制単語	叩き返し
たたきかえす	たたき返す	抑制単語	叩き返す
たたきかため	たたき固め	抑制単語	叩き固め
たたききっ	たたき切っ	抑制単語	叩き切っ
たたききる	たたき切る	抑制単語	叩き切る
たたきくだい	たたき砕い	抑制単語	叩き砕い
たたきこま	たたき込ま	抑制単語	叩き込ま
たたきこみ	たたき込み	抑制単語	叩き込み
たたきこむ	たたき込む	抑制単語	叩き込む
たたきこめ	たたき込め	抑制単語	叩き込め
たたきこめ	たたき込め	抑制単語	叩き込め
たたきこめる	たたき込める	抑制単語	叩き込める
たたきこも	たたき込も	抑制単語	叩き込も
たたきこん	たたき込ん	抑制単語	叩き込ん
たたきしあげ	たたき仕上げ	抑制単語	叩き仕上げ
たたきぞめ	たたき染め	抑制単語	叩き染め
たたきだい	たたき台	抑制単語	叩き台
たたきださ	たたき出さ	抑制単語	叩き出さ
たたきだし	たたき出し	抑制単語	叩き出し
たたきだす	たたき出す	抑制単語	叩き出す
たたきだせ	たたき出せ	抑制単語	叩き出せ
たたきだせ	たたき出せ	抑制単語	叩き出せ
たたきだせ	たたき出せ	抑制単語	叩き出せ
たたきだせ	たたき出せ	抑制単語	叩き出せ
たたきだせる	たたき出せる	抑制単語	叩き出せる
たたきだそ	たたき出そ	抑制単語	叩き出そ
たたきづけ	たたき付け	抑制単語	叩き付け
たたきぼう	たたき棒	抑制単語	叩き棒
たたきわり	たたき割り	抑制単語	叩き割り
たたりめ	たたり目	抑制単語	祟り目
ただいま	ただ今	抑制単語	只今
ただごと	ただ事	抑制単語	只事
ただなか	ただ中	抑制単語	只中
ただもの	ただ者	抑制単語	只者
たちあがっ	たち上がっ	抑制単語	勃ち上がっ
たちくらみ	立ちくらみ	抑制単語	立ち眩み
たちこぎ	立ちこぎ	抑制単語	立ち漕ぎ
たちこめ	立ちこめ	抑制単語	立ち籠め
たちこめる	立ちこめる	抑制単語	立ち籠める
たちさばき	太刀さばき	抑制単語	太刀捌き
たちすくみ	立ちすくみ	抑制単語	立ち竦み
たちすくむ	立ちすくむ	抑制単語	立ち竦む
たちすくん	立ちすくん	抑制単語	立ち竦ん
たちふさがっ	立ちふさがっ	抑制単語	立ち塞がっ
たちふさがり	立ちふさがり	抑制単語	立ち塞がり
たちふさがる	立ちふさがる	抑制単語	立ち塞がる
たちふさがろ	立ちふさがろ	抑制単語	立ち塞がろ
たちふさがろう	立ちふさがろう	抑制単語	立ち塞がろう
たちよりいただけ	立ち寄りいただけ	抑制単語	立ち寄り戴け
たつみや	たつみ屋	抑制単語	辰巳屋
たづなさばき	手綱さばき	抑制単語	手綱捌き
たてあな	たて穴	抑制単語	竪穴
たてこもっ	立てこもっ	抑制単語	立て篭っ
たてこもっ	立てこもっ	抑制単語	立て篭もっ
たてこもっ	立てこもっ	抑制単語	立て籠っ
たてこもっ	立てこもっ	抑制単語	立て籠もっ
たてこもり	立てこもり	抑制単語	立て篭もり
たてこもり	立てこもり	抑制単語	立て篭り
たてこもり	立てこもり	抑制単語	立て籠もり
たてこもり	立てこもり	抑制単語	立て籠り
たてこもる	立てこもる	抑制単語	立て篭もる
たてこもる	立てこもる	抑制単語	立て篭る
たてこもる	立てこもる	抑制単語	立て籠もる
たてこもる	立てこもる	抑制単語	立て籠る
たてじま	縦じま	抑制単語	縦縞
たどってほしい	たどって欲しい	抑制単語	辿って欲しい
たどりき	たどり着	抑制単語	辿り着
たどりつい	たどり着い	抑制単語	辿り着い
たどりついていれば	たどり着いていれば	抑制単語	辿り着いていれば
たどりつか	たどり着か	抑制単語	辿り着か
たどりつかん	たどり着かん	抑制単語	辿り着かん
たどりつき	たどり着き	抑制単語	辿り着き
たどりつきにくい	たどり着きにくい	抑制単語	辿り着きにくい
たどりつきやすい	たどり着きやすい	抑制単語	辿り着きやすい
たどりつきやすく	たどり着きやすく	抑制単語	辿り着きやすく
たどりつく	たどり着く	抑制単語	辿り着く
たどりつけ	たどり付け	抑制単語	辿り付け
たどりつけ	たどり着け	抑制単語	辿り着け
たどりつけ	たどり着け	抑制単語	辿り着け
たどりつけ	たどり着け	抑制単語	辿り着け
たどりつけ	たどり着け	抑制単語	辿り着け
たどりつけなくなっ	たどり着けなくなっ	抑制単語	辿り着けなくなっ
たどりつけなくなり	たどり着けなくなり	抑制単語	辿り着けなくなり
たどりつけなくなる	たどり着けなくなる	抑制単語	辿り着けなくなる
たどりつける	たどり着ける	抑制単語	辿り着ける
たどりつけれ	たどり着けれ	抑制単語	辿り着けれ
たどりつけん	たどり着けん	抑制単語	辿り着けん
たどりつけん	たどり着けん	抑制単語	辿り着けん
たどりつこ	たどり着こ	抑制単語	辿り着こ
たなざらし	店ざらし	抑制単語	店晒し
たねまき	種まき	抑制単語	種蒔
たねまき	種まき	抑制単語	種蒔き
たねもみ	種もみ	抑制単語	種籾
たのうほう	多のう胞	抑制単語	多嚢胞
たのうほうせい	多のう胞性	抑制単語	多嚢胞性
たのしみいただき	楽しみいただき	抑制単語	楽しみ戴き
たのしみいただく	楽しみいただく	抑制単語	楽しみ戴く
たのしみいただけ	楽しみいただけ	抑制単語	楽しみ戴け
たのしみいただける	楽しみいただける	抑制単語	楽しみ戴ける
たのしみいただけれ	楽しみいただけれ	抑制単語	楽しみ戴けれ
たのしみがい	楽しみがい	抑制単語	楽しみ甲斐
たべかす	食べかす	抑制単語	食べ滓
たべがい	食べがい	抑制単語	食べ甲斐
たべごろ	食べごろ	抑制単語	食べ頃
たべなれ	食べなれ	抑制単語	食べ馴れ
たまぐし	玉ぐし	抑制単語	玉串
たまごとじ	玉子とじ	抑制単語	玉子綴じ
たまねぎ	玉ねぎ	抑制単語	玉葱
たまのこし	玉のこし	抑制単語	玉の輿
たまりしだい	たまり次第	抑制単語	溜まり次第
たまりしだい	たまり次第	抑制単語	溜まり次第
たまりせき	たまり席	抑制単語	溜まり席
たまりば	たまり場	抑制単語	溜まり場
たまりば	たまり場	抑制単語	溜り場
たまりほうだい	たまり放題	抑制単語	溜まり放題
ためいき	ため息	抑制単語	溜息
ためいけ	ため池	抑制単語	溜池
ためいろあせ	ため色あせ	抑制単語	ため色褪せ
ためうち	ため打ち	抑制単語	溜め打ち
ためうち	ため撃ち	抑制単語	溜め撃ち
ためおし	ため押し	抑制単語	溜め押し
ためこま	ため込ま	抑制単語	溜め込ま
ためこみ	ため込み	抑制単語	溜め込み
ためこみがち	ため込みがち	抑制単語	溜め込みがち
ためこみやすい	ため込みやすい	抑制単語	溜め込みやすい
ためこみやすく	ため込みやすく	抑制単語	溜め込みやすく
ためこむ	ため込む	抑制単語	溜め込む
ためこめ	ため込め	抑制単語	溜め込め
ためこめる	ため込める	抑制単語	溜め込める
ためこも	ため込も	抑制単語	溜め込も
ためころし	ため殺し	抑制単語	溜め殺し
ためこん	ため込ん	抑制単語	溜め込ん
ためしいただき	試しいただき	抑制単語	試し戴き
ためしにつない	試しにつない	抑制単語	試しに繋い
ためとり	ため撮り	抑制単語	溜め撮り
ためらいきず	ためらい傷	抑制単語	躊躇い傷
たもとをわかち	たもとを分かち	抑制単語	袂を分かち
たもとをわかつ	たもとを分かつ	抑制単語	袂を分かつ
たもろもろ	他もろもろ	抑制単語	他諸々
たよりがい	頼りがい	抑制単語	頼り甲斐
たらしこむ	たらし込む	抑制単語	誑し込む
たらしこん	たらし込ん	抑制単語	誑し込ん
たらのこ	たらの子	抑制単語	鱈の子
たんかんがん	胆管がん	抑制単語	胆管癌
たんじん	炭じん	抑制単語	炭塵
たんのう	胆のう	抑制単語	胆嚢
たんのう	胆のう	抑制単語	胆囊
たんのうえん	胆のう炎	抑制単語	胆嚢炎
たんぱくかすいぶんかいぶつ	たんぱく加水分解物	抑制単語	蛋白加水分解物
たんぱくげん	たんぱく源	抑制単語	蛋白源
たんぼ	田んぼ	抑制単語	田圃
だいあじ	大あじ	抑制単語	大鯵
だいあん	大あん	抑制単語	大庵
だいかに	大かに	抑制単語	大蟹
だいかんばつ	大干ばつ	抑制単語	大旱魃
だいがま	大がま	抑制単語	大蝦蟇
だいがん	大がん	抑制単語	大癌
だいこんもち	大根もち	抑制単語	大根餅
だいごちそう	大ごちそう	抑制単語	大ご馳走
だいごみ	だいご味	抑制単語	醍醐味
だいさく	大さく	抑制単語	大柵
だいしょうさまざま	大小さまざま	抑制単語	大小様々
だいちょうがん	大腸がん	抑制単語	大腸癌
だいつりばし	大つり橋	抑制単語	大吊り橋
だいつりばし	大つり橋	抑制単語	大吊橋
だいとり	大とり	抑制単語	大酉
だいなまず	大なまず	抑制単語	大鯰
だいにぎわい	大にぎわい	抑制単語	大賑
だいはし	大はし	抑制単語	大箸
だいばかしゃ	大ばか者	抑制単語	大馬鹿者
だいばってき	大抜てき	抑制単語	大抜擢
だいひょうあいさつ	代表あいさつ	抑制単語	代表挨拶
だいひんしゅく	大ひんしゅく	抑制単語	大顰蹙
だいふくもち	大福もち	抑制単語	大福餅
だいみこし	大みこし	抑制単語	大御輿
だいりびな	内裏びな	抑制単語	内裏雛
だいわらじ	大わらじ	抑制単語	大草鞋
だえき	だ液	抑制単語	唾液
だえん	だ円	抑制単語	楕円
だきつぶし	抱きつぶし	抑制単語	抱き潰し
だだっこ	だだっ子	抑制単語	駄々っ子
だっきゅう	脱きゅう	抑制単語	脱臼
だっこひも	抱っこひも	抑制単語	抱っこ紐
だっこひもかばー	抱っこひもカバー	抑制単語	抱っこ紐カバー
だつひばく	脱被ばく	抑制単語	脱被曝
だてまき	だて巻き	抑制単語	伊達巻
だほ	だ捕	抑制単語	拿捕
だましうち	だまし打ち	抑制単語	騙し打ち
だましうち	だまし撃ち	抑制単語	騙し撃ち
だましうち	だまし討ち	抑制単語	騙し討ち
だましうち	だまし討	抑制単語	騙し討
だましうり	だまし売り	抑制単語	騙し売り
だましえ	だまし絵	抑制単語	騙し絵
だましとおせる	だまし通せる	抑制単語	騙し通せる
だましとっ	だまし取っ	抑制単語	騙し取っ
だましとら	だまし取ら	抑制単語	騙し取ら
だましとり	だまし取り	抑制単語	騙し取り
だましとる	だまし取る	抑制単語	騙し取る
だましとろ	だまし取ろ	抑制単語	騙し取ろ
だみんをむさぼっ	惰眠をむさぼっ	抑制単語	惰眠を貪っ
だみんをむさぼり	惰眠をむさぼり	抑制単語	惰眠を貪り
だみんをむさぼる	惰眠をむさぼる	抑制単語	惰眠を貪る
だんがい	断がい	抑制単語	断崖
だんだんあかく	だんだん赤く	抑制単語	段々赤く
だんだんあかるく	だんだん明るく	抑制単語	段々明るく
だんだんあさく	だんだん浅く	抑制単語	段々浅く
だんだんあたたかく	だんだん暖かく	抑制単語	段々暖かく
だんだんあたたかく	だんだん温かく	抑制単語	段々温かく
だんだんあったかく	だんだん暖かく	抑制単語	段々暖かく
だんだんあつく	だんだん厚く	抑制単語	段々厚く
だんだんあつく	だんだん暑く	抑制単語	段々暑く
だんだんあつく	だんだん熱く	抑制単語	段々熱く
だんだんあまく	だんだん甘く	抑制単語	段々甘く
だんだんあやしく	だんだん怪しく	抑制単語	段々怪しく
だんだんいきぐるしく	だんだん息苦しく	抑制単語	段々息苦しく
だんだんいそがしく	だんだん忙しく	抑制単語	段々忙しく
だんだんいたく	だんだん痛く	抑制単語	段々痛く
だんだんうすく	だんだん薄く	抑制単語	段々薄く
だんだんうすぐらく	だんだん薄暗く	抑制単語	段々薄暗く
だんだんうまく	だんだん上手く	抑制単語	段々上手く
だんだんおいしく	だんだん美味しく	抑制単語	段々美味しく
だんだんおおきく	だんだん大きく	抑制単語	段々大きく
だんだんおおく	だんだん多く	抑制単語	段々多く
だんだんおそく	だんだん遅く	抑制単語	段々遅く
だんだんおもく	だんだん重く	抑制単語	段々重く
だんだんおもしろく	だんだん面白く	抑制単語	段々面白く
だんだんかたく	だんだん固く	抑制単語	段々固く
だんだんかたく	だんだん硬く	抑制単語	段々硬く
だんだんかなしく	だんだん悲しく	抑制単語	段々悲しく
だんだんからく	だんだん辛く	抑制単語	段々辛く
だんだんかるく	だんだん軽く	抑制単語	段々軽く
だんだんかわいく	だんだん可愛く	抑制単語	段々可愛く
だんだんきいろく	だんだん黄色く	抑制単語	段々黄色く
だんだんきたなく	だんだん汚く	抑制単語	段々汚く
だんだんきびしく	だんだん厳しく	抑制単語	段々厳しく
だんだんきもちよく	だんだん気持ちよく	抑制単語	段々気持ちよく
だんだんきもちよく	だんだん気持ち良く	抑制単語	段々気持ちよく
だんだんきもちわるく	だんだん気持ち悪く	抑制単語	段々気持ち悪く
だんだんくらく	だんだん暗く	抑制単語	段々暗く
だんだんくるしく	だんだん苦しく	抑制単語	段々苦しく
だんだんくろく	だんだん黒く	抑制単語	段々黒く
だんだんけわしく	だんだん険しく	抑制単語	段々険しく
だんだんこい	だんだん濃い	抑制単語	段々濃い
だんだんこえがおおきく	だんだん声が大きく	抑制単語	段々声が大きく
だんだんこく	だんだん濃く	抑制単語	段々濃く
だんだんこまかい	だんだん細かい	抑制単語	段々細かい
だんだんこまかく	だんだん細かく	抑制単語	段々細かく
だんだんこわく	だんだん怖く	抑制単語	段々怖く
だんだんさびしく	だんだん寂しく	抑制単語	段々寂しく
だんだんさむく	だんだん寒く	抑制単語	段々寒く
だんだんしぶく	だんだん渋く	抑制単語	段々渋く
だんだんしろく	だんだん白く	抑制単語	段々白く
だんだんすくなく	だんだん少なく	抑制単語	段々少なく
だんだんすずしく	だんだん涼しく	抑制単語	段々涼しく
だんだんせまく	だんだん狭く	抑制単語	段々狭く
だんだんたかい	だんだん高い	抑制単語	段々高い
だんだんたかく	だんだん高く	抑制単語	段々高く
だんだんたのしく	だんだん楽しく	抑制単語	段々楽しく
だんだんちいさく	だんだん小さく	抑制単語	段々小さく
だんだんつめたく	だんだん冷たく	抑制単語	段々冷たく
だんだんつよい	だんだん強い	抑制単語	段々強い
だんだんつよく	だんだん強く	抑制単語	段々強く
だんだんつらく	だんだん辛く	抑制単語	段々辛く
だんだんとおく	だんだん遠く	抑制単語	段々遠く
だんだんながく	だんだん長く	抑制単語	段々長く
だんだんねむく	だんだん眠く	抑制単語	段々眠く
だんだんはげしく	だんだん激しく	抑制単語	段々激しく
だんだんはずかしく	だんだん恥ずかしく	抑制単語	段々恥ずかしく
だんだんはやく	だんだん早く	抑制単語	段々早く
だんだんはやく	だんだん速く	抑制単語	段々速く
だんだんひくく	だんだん低く	抑制単語	段々低く
だんだんひどく	だんだん酷く	抑制単語	段々酷く
だんだんひろく	だんだん広く	抑制単語	段々広く
だんだんふかく	だんだん深く	抑制単語	段々深く
だんだんふとく	だんだん太く	抑制単語	段々太く
だんだんほしく	だんだん欲しく	抑制単語	段々欲しく
だんだんほそく	だんだん細く	抑制単語	段々細く
だんだんまるく	だんだん丸く	抑制単語	段々丸く
だんだんみじかく	だんだん短く	抑制単語	段々短く
だんだんむごく	だんだん酷く	抑制単語	段々酷く
だんだんむずかしい	だんだん難しい	抑制単語	段々難しい
だんだんむずかしく	だんだん難しく	抑制単語	段々難しく
だんだんむつかしく	だんだん難しく	抑制単語	段々難しく
だんだんめんどうくさく	だんだん面倒くさく	抑制単語	段々面倒くさく
だんだんめんどうくさく	だんだん面倒臭く	抑制単語	段々面倒くさく
だんだんめんどくさく	だんだん面倒くさく	抑制単語	段々面倒くさく
だんだんものたりなく	だんだん物足りなく	抑制単語	段々物足りなく
だんだんやすく	だんだん安く	抑制単語	段々安く
だんだんやわらかく	だんだん柔らかく	抑制単語	段々柔らかく
だんだんゆるく	だんだん緩く	抑制単語	段々緩く
だんだんよい	だんだん良い	抑制単語	段々良い
だんだんよく	だんだん良く	抑制単語	段々良く
だんだんよわく	だんだん弱く	抑制単語	段々弱く
だんだんわるい	だんだん悪い	抑制単語	段々悪い
だんだんわるく	だんだん悪く	抑制単語	段々悪く
だんなさま	だんな様	抑制単語	旦那様
だんらん	団らん	抑制単語	団欒
ちえのわ	ちえの輪	抑制単語	智慧の輪
ちかごろ	近ごろ	抑制単語	近頃
ちからこぶ	力こぶ	抑制単語	力瘤
ちがいにつながる	違いにつながる	抑制単語	違いに繋がる
ちしぶき	血しぶき	抑制単語	血飛沫
ちとせあめ	千歳あめ	抑制単語	千歳飴
ちなまぐさい	血なまぐさい	抑制単語	血腥い
ちのり	血のり	抑制単語	血糊
ちはつ	ち髪	抑制単語	薙髪
ちほう	痴ほう	抑制単語	痴呆
ちほうしょう	痴ほう症	抑制単語	痴呆症
ちみつ	ち密	抑制単語	緻密
ちみつさ	ち密さ	抑制単語	緻密さ
ちゃがま	茶がま	抑制単語	茶釜
ちゃこし	茶こし	抑制単語	茶漉し
ちゃしゃく	茶しゃく	抑制単語	茶杓
ちゃせん	茶せん	抑制単語	茶筅
ちゃせん	茶せん	抑制単語	茶筌
ちゃだんす	茶だんす	抑制単語	茶箪笥
ちゃぶだい	ちゃぶ台	抑制単語	卓袱台
ちゃわん	茶わん	抑制単語	茶碗
ちゅうかそば	中華そば	抑制単語	中華蕎麦
ちゅうかなべ	中華なべ	抑制単語	中華鍋
ちゅうかめん	中華めん	抑制単語	中華麺
ちゅうじゅんごろ	中旬ごろ	抑制単語	中旬頃
ちゅうずり	宙づり	抑制単語	宙吊り
ちゅうせん	抽せん	抑制単語	抽籤
ちゅうづり	宙づり	抑制単語	宙吊り
ちゅうぼう	ちゅう房	抑制単語	厨房
ちょうおしゃれ	超おしゃれ	抑制単語	超お洒落
ちょうおてごろ	超お手ごろ	抑制単語	超お手頃
ちょうかん	鳥かん	抑制単語	鳥瞰
ちょうしょう	ちょう笑	抑制単語	嘲笑
ちょうしょう	長しょう	抑制単語	長嘯
ちょうじり	帳じり	抑制単語	帳尻
ちょうたく	彫たく	抑制単語	彫琢
ちょうだい	頂だい	抑制単語	頂戴
ちょうはやぶさ	超はやぶさ	抑制単語	超隼
ちょくちょうがん	直腸がん	抑制単語	直腸癌
ちょっとうさんくさい	ちょっとうさん臭い	抑制単語	ちょっと胡散臭い
ちょっとはがゆい	ちょっと歯がゆい	抑制単語	ちょっと歯痒い
ちりがみ	ちり紙	抑制単語	塵紙
ちんうつ	沈うつ	抑制単語	沈鬱
ちんうつ	沈うつ	抑制単語	沈鬱
ちんでん	沈でん	抑制単語	沈澱
ちんにゅう	ちん入	抑制単語	闖入
ついさきごろ	つい先ごろ	抑制単語	つい先頃
つうば	痛ば	抑制単語	痛罵
つかいいただけ	使いいただけ	抑制単語	使い戴け
つかいがい	使いがい	抑制単語	使い甲斐
つかいつぶさ	使いつぶさ	抑制単語	使い潰さ
つかいつぶし	使いつぶし	抑制単語	使い潰し
つかいつぶす	使いつぶす	抑制単語	使い潰す
つかいつぶせる	使いつぶせる	抑制単語	使い潰せる
つかいなじん	使いなじん	抑制単語	使い馴染ん
つかいなれ	使いなれ	抑制単語	使い馴れ
つかいまわし	使いまわし	抑制単語	使い廻し
つかいまわす	使いまわす	抑制単語	使い廻す
つかみあい	つかみ合い	抑制単語	掴み合い
つかみあう	つかみ合う	抑制単語	掴み合う
つかみあげ	つかみ上げ	抑制単語	掴み上げ
つかみあげる	つかみ上げる	抑制単語	掴み上げる
つかみあっ	つかみ合っ	抑制単語	掴み合っ
つかみかかっ	つかみ掛かっ	抑制単語	掴み掛かっ
つかみかかっ	つかみ掛かっ	抑制単語	掴み掛っ
つかみそこね	つかみ損ね	抑制単語	掴み損ね
つかみそこねる	つかみ損ねる	抑制単語	掴み損ねる
つかみたべ	つかみ食べ	抑制単語	掴み食べ
つかみだし	つかみ出し	抑制単語	掴み出し
つかみとっ	つかみ取っ	抑制単語	掴み取っ
つかみとってほしい	つかみ取ってほしい	抑制単語	掴み取ってほしい
つかみとら	つかみ取ら	抑制単語	掴み取ら
つかみとり	つかみ取り	抑制単語	掴み取り
つかみとる	つかみ取る	抑制単語	掴み取る
つかみとる	つかみ取る	抑制単語	摑み取る
つかみとれ	つかみ取れ	抑制単語	掴み取れ
つかみとれ	つかみ取れ	抑制単語	掴み取れ
つかみとれ	つかみ取れ	抑制単語	掴み取れ
つかみとれる	つかみ取れる	抑制単語	掴み取れる
つかみとろ	つかみ取ろ	抑制単語	掴み取ろ
つかみどり	つかみ取り	抑制単語	掴み取り
つかみにくい	つかみ難い	抑制単語	掴み難い
つかれたまっ	疲れたまっ	抑制単語	疲れ溜まっ
つきあいいただい	付き合いいただい	抑制単語	付き合い戴い
つきあいいただき	つき合いいただき	抑制単語	付き合い戴き
つきあいいただき	つき合い頂き	抑制単語	付き合い戴き
つきあいいただき	付き合いいただき	抑制単語	付き合い戴き
つきあいいただき	付合いいただき	抑制単語	付き合い戴き
つきあいいただけ	つき合いいただけ	抑制単語	付き合い戴け
つきあいいただけ	付き合いいただけ	抑制単語	付き合い戴け
つきあいいただけれ	つき合いいただけれ	抑制単語	付き合い戴けれ
つきあいいただけれ	付き合いいただけれ	抑制単語	付き合い戴けれ
つきあがっ	つき上がっ	抑制単語	搗き上がっ
つきあげ	つき上げ	抑制単語	搗き上げ
つきおとし	つき落とし	抑制単語	憑き落とし
つきかため	つき固め	抑制単語	搗き固め
つきこん	つき込ん	抑制単語	搗き込ん
つきたて	つき立て	抑制単語	搗き立て
つきだて	つき立て	抑制単語	搗き立て
つきほうだい	つき放題	抑制単語	撞き放題
つきまくっ	付きまくっ	抑制単語	付き捲っ
つきまとい	付きまとい	抑制単語	付き纏い
つきまとう	付きまとう	抑制単語	付き纏う
つきまとっ	付きまとっ	抑制単語	付き纏っ
つきまとわ	付きまとわ	抑制単語	付き纏わ
つきもの	付き物	抑制単語	憑物
つきもの	つき物	抑制単語	憑き物
つきもの	つき物	抑制単語	憑物
つぎつぎあたらしい	つぎつぎ新しい	抑制単語	次々新しい
つぎつぎに	次ぎ次ぎに	抑制単語	次々に
つくだに	つくだ煮	抑制単語	佃煮
つくりがい	作りがい	抑制単語	作り甲斐
つくりため	作りため	抑制単語	作り溜め
つけひげ	付けひげ	抑制単語	付け髭
つけまつげ	付けまつげ	抑制単語	付け睫
つじつまあわせ	つじつま合わせ	抑制単語	辻褄合わせ
つじつまあわせ	つじつま合わせ	抑制単語	辻褄合わせ
つじつまがあい	つじつまが合い	抑制単語	辻褄が合い
つじつまがあう	つじつまが合う	抑制単語	辻褄が合う
つじつまがあえ	つじつまが合え	抑制単語	辻褄が合え
つじつまがあっ	つじつまが合っ	抑制単語	辻褄が合っ
つじつまがあわ	つじつまが合わ	抑制単語	辻褄が合わ
つじつまがあわん	つじつまが合わん	抑制単語	辻褄が合わん
つじつまをあわせよ	つじつまを合わせよ	抑制単語	辻褄を合わせよ
つじつまをあわせる	つじつまを合わせる	抑制単語	辻褄を合わせる
つずらおり	つづら折り	抑制単語	葛折
つずりかた	つづり方	抑制単語	綴方
つずれおり	つづれ織り	抑制単語	綴れ織り
つちぼこり	土ぼこり	抑制単語	土埃
つっぱね	突っぱね	抑制単語	突っ撥ね
つっぱね	突っぱね	抑制単語	突っ撥ね
つっぱねる	突っぱねる	抑制単語	突っ撥ねる
つづらおり	つづら折り	抑制単語	葛折
つづりあわせ	つづり合わせ	抑制単語	綴り合わせ
つづりかた	つづり方	抑制単語	綴方
つづりじ	つづり字	抑制単語	綴り字
つづりちがう	つづり違う	抑制単語	綴り違う
つづりまちがえ	つづり間違え	抑制単語	綴り間違え
つづりまちがっ	つづり間違っ	抑制単語	綴り間違っ
つづれおり	つづれ織り	抑制単語	綴れ織り
つながってほしい	つながって欲しい	抑制単語	繋がって欲しい
つながりあえ	つながり合え	抑制単語	繋がり合え
つながりあえる	つながり合える	抑制単語	繋がり合える
つながりかね	つながり兼ね	抑制単語	繋がり兼ね
つながりにくい	つながり難い	抑制単語	繋がり難い
つながりもっ	つながり持っ	抑制単語	繋がり持っ
つなぎあるい	つなぎ歩い	抑制単語	繋ぎ歩い
つなぎあるく	つなぎ歩く	抑制単語	繋ぎ歩く
つなぎあわさ	つなぎ合わさ	抑制単語	繋ぎ合わさ
つなぎあわさっ	つなぎ合わさっ	抑制単語	繋ぎ合わさっ
つなぎあわせ	つなぎ合せ	抑制単語	繋ぎ合せ
つなぎあわせ	つなぎ合せ	抑制単語	繋ぎ合わせ
つなぎあわせ	つなぎ合わせ	抑制単語	繋ぎ合せ
つなぎあわせ	つなぎ合わせ	抑制単語	繋ぎ合わせ
つなぎあわせ	つなぎ合わせ	抑制単語	繋ぎ合わせ
つなぎあわせ	つなぎ合わせ	抑制単語	繋ぎ合わせ
つなぎあわせ	つなぎ合わせ	抑制単語	繋ぎ合わせ
つなぎあわせる	つなぎ合せる	抑制単語	繋ぎ合せる
つなぎあわせる	つなぎ合わせる	抑制単語	繋ぎ合わせる
つなぎあわせれ	つなぎ合わせれ	抑制単語	繋ぎ合わせれ
つなぎいたし	つなぎ致し	抑制単語	繋ぎ致し
つなぎうり	つなぎ売り	抑制単語	繋ぎ売り
つなぎかい	つなぎ飼い	抑制単語	繋ぎ飼い
つなぎかえ	つなぎ換え	抑制単語	繋ぎ換え
つなぎかえ	つなぎ替え	抑制単語	繋ぎ替え
つなぎかえる	つなぎ替える	抑制単語	繋ぎ替える
つなぎこみ	つなぎ込み	抑制単語	繋ぎ込み
つなぎでき	つなぎ出来	抑制単語	繋ぎ出来
つなぎとめ	つなぎ止め	抑制単語	繋ぎ止め
つなぎとめ	つなぎ止め	抑制単語	繋ぎ止め
つなぎとめ	つなぎ留め	抑制単語	繋ぎ留め
つなぎとめ	つなぎ留め	抑制単語	繋ぎ留め
つなぎとめよ	つなぎ止めよ	抑制単語	繋ぎ止めよ
つなぎとめる	つなぎ止める	抑制単語	繋ぎ止める
つなぎとめる	つなぎ留める	抑制単語	繋ぎ留める
つなぎなおし	つなぎ直し	抑制単語	繋ぎ直し
つなぎほうだい	つなぎ放題	抑制単語	繋ぎ放題
つなぎまちがえ	つなぎ間違え	抑制単語	繋ぎ間違え
つなぎわすれ	つなぎ忘れ	抑制単語	繋ぎ忘れ
つばぜりあい	つばぜり合い	抑制単語	鍔迫り合い
つぶあん	粒あん	抑制単語	粒餡
つぶしあい	つぶし合い	抑制単語	潰し合い
つぶしがきか	つぶしが利か	抑制単語	潰しが利か
つぶしがきか	つぶしが効か	抑制単語	潰しが効か
つぶしがきき	つぶしが効き	抑制単語	潰しが効き
つぶしがきく	つぶしが利く	抑制単語	潰しが利く
つぶしがきく	つぶしが効く	抑制単語	潰しが効く
つぶしきか	つぶし効か	抑制単語	潰し効か
つぶぞろい	粒ぞろい	抑制単語	粒揃い
つぶやきけし	つぶやき消し	抑制単語	呟き消し
つぶやきみ	つぶやき見	抑制単語	呟き見
つぶやきみる	つぶやき見る	抑制単語	呟き見る
つぶやきよん	つぶやき読ん	抑制単語	呟き読ん
つぶやきわすれ	つぶやき忘れ	抑制単語	呟き忘れ
つぼづけ	つぼ漬け	抑制単語	壺漬
つぼやき	つぼ焼き	抑制単語	壷焼
つぼやき	つぼ焼き	抑制単語	壷焼き
つぼやき	つぼ焼き	抑制単語	壺焼
つぼやき	つぼ焼き	抑制単語	壺焼き
つまさきだち	つま先立ち	抑制単語	爪先立ち
つまさきだちし	つま先立ちし	抑制単語	爪先立ちし
つまさきだちする	つま先立ちする	抑制単語	爪先立ちする
つまさきだっ	つま先立っ	抑制単語	爪先立っ
つまずきころん	つまずき転ん	抑制単語	躓き転ん
つまびい	つま弾い	抑制単語	爪弾い
つまびか	つま弾か	抑制単語	爪弾か
つまびき	つま弾き	抑制単語	爪弾き
つまびく	つま弾く	抑制単語	爪弾く
つまようじいれ	つまようじ入れ	抑制単語	爪楊枝入れ
つめあと	つめ跡	抑制単語	爪跡
つめたいそば	冷たいそば	抑制単語	冷たい蕎麦
つやあり	つや有り	抑制単語	艶有り
つやけし	つや消	抑制単語	艶消し
つやだし	つや出し	抑制単語	艶出し
つやはだ	つや肌	抑制単語	艶肌
つゆはらい	露払い	抑制単語	露祓
つりあがっ	つり上がっ	抑制単語	吊り上がっ
つりあがっ	つり上がっ	抑制単語	吊上がっ
つりあがっ	釣り上がっ	抑制単語	吊上がっ
つりあがり	つり上がり	抑制単語	吊り上がり
つりあがる	つり上がる	抑制単語	吊り上がる
つりあげ	つり上げ	抑制単語	吊り上げ
つりあげ	つり上げ	抑制単語	吊上げ
つりあげ	つり上げ	抑制単語	吊り上げ
つりあげ	つり上げ	抑制単語	吊上げ
つりあげ	釣り上げ	抑制単語	吊上げ
つりあげ	釣り上げ	抑制単語	吊上げ
つりあげよ	つり上げよ	抑制単語	吊り上げよ
つりあげる	つり上げる	抑制単語	吊り上げる
つりあげる	つり上げる	抑制単語	吊上げる
つりあげる	釣り上げる	抑制単語	吊上げる
つりおろし	つり降ろし	抑制単語	吊り降ろし
つりこみ	つり込み	抑制単語	吊り込み
つりさげ	つり下げ	抑制単語	吊り下げ
つりさげ	つり下げ	抑制単語	吊り下げ
つりさげ	つり下げ	抑制単語	吊り下げ
つりさげる	つり下げる	抑制単語	吊り下げる
つりだし	つり出し	抑制単語	吊り出し
つりて	釣り手	抑制単語	吊手
つりに	つり荷	抑制単語	吊り荷
つりはち	つり鉢	抑制単語	吊り鉢
つりばし	つり橋	抑制単語	吊り橋
つりばし	つり橋	抑制単語	吊橋
つりばし	釣り橋	抑制単語	吊橋
つりわ	つり輪	抑制単語	吊り輪
つるしあげ	つるし上げ	抑制単語	吊し上げ
つるしあげ	つるし上げ	抑制単語	吊し上げ
つるしあげ	つるし上げ	抑制単語	吊るし上げ
つるしあげ	つるし上げ	抑制単語	吊し上げ
つるしあげ	つるし上げ	抑制単語	吊るし上げ
つるしあげる	つるし上げる	抑制単語	吊し上げる
つるしあげる	つるし上げる	抑制単語	吊るし上げる
つるしあげろ	つるし上げろ	抑制単語	吊し上げろ
つるしあげろ	つるし上げろ	抑制単語	吊るし上げろ
つるしかざり	つるし飾り	抑制単語	吊し飾り
つるしかざり	つるし飾り	抑制単語	吊るし飾り
つるしくも	つるし雲	抑制単語	吊るし雲
つるしょくぶつ	つる植物	抑制単語	蔓植物
つれさらわ	連れさらわ	抑制単語	連れ攫わ
てあか	手あか	抑制単語	手垢
ていたんぱく	低たんぱく	抑制単語	低蛋白
ていたんぱくしょく	低たんぱく食	抑制単語	低蛋白食
ていだん	てい談	抑制単語	鼎談
ていてつ	てい鉄	抑制単語	蹄鉄
ていひばく	低被ばく	抑制単語	低被曝
ていりつ	てい立	抑制単語	鼎立
てうちそば	手打そば	抑制単語	手打蕎麦
てうちそば	手打ちそば	抑制単語	手打ち蕎麦
てうちそばや	手打ちそば屋	抑制単語	手打ち蕎麦屋
ておけ	手おけ	抑制単語	手桶
てかせ	手かせ	抑制単語	手枷
てこいれ	てこ入れ	抑制単語	梃入れ
てこぎ	手こぎ	抑制単語	手漕ぎ
てこずっ	手こずっ	抑制単語	手古摺っ
てこずり	手こずり	抑制単語	手古摺り
てこずる	手こずる	抑制単語	手古摺る
てごま	手ごま	抑制単語	手駒
てごめ	手ごめ	抑制単語	手篭
てごめ	手ごめ	抑制単語	手篭め
てごめ	手ごめ	抑制単語	手籠
てごめ	手ごめ	抑制単語	手籠め
てごめ	手込め	抑制単語	手篭
てごめ	手込め	抑制単語	手籠
てごろ	手ごろ	抑制単語	手頃
てごろ	手ごろ	抑制単語	手頃
てごろかん	手ごろ感	抑制単語	手頃感
てごろさ	手ごろさ	抑制単語	手頃さ
てさばき	手さばき	抑制単語	手捌き
てすき	手すき	抑制単語	手漉き
てすき	手すき	抑制単語	手隙
てすき	手透き	抑制単語	手隙
てすり	手すり	抑制単語	手摺
てずかみ	手づかみ	抑制単語	手掴み
てずる	手づる	抑制単語	手蔓
てっかみそ	鉄火みそ	抑制単語	鉄火味噌
てつかぶと	鉄かぶと	抑制単語	鉄兜
てつくず	鉄くず	抑制単語	鉄屑
てつなぎ	手つなぎ	抑制単語	手繋ぎ
てづかみ	手づかみ	抑制単語	手掴み
てづくりせっけん	手作り石けん	抑制単語	手作り石鹸
てづる	手づる	抑制単語	手蔓
てなれ	手なれ	抑制単語	手馴れ
てぬぐい	手ぬぐい	抑制単語	手拭
てぬぐい	手ぬぐい	抑制単語	手拭い
てのべそうめん	手延べそうめん	抑制単語	手延べ素麺
てはず	手はず	抑制単語	手筈
てふき	手ふき	抑制単語	手拭き
てまえみそ	手前みそ	抑制単語	手前味噌
てまくら	手まくら	抑制単語	手枕
てまひま	手間ひま	抑制単語	手間隙
てまひまかけ	手間ひまかけ	抑制単語	手間隙かけ
てまり	手まり	抑制単語	手毬
てまり	手まり	抑制単語	手鞠
てもみ	手もみ	抑制単語	手揉み
てをこまぬい	手をこまぬい	抑制単語	手を拱い
てをこまねい	手をこまねい	抑制単語	手を拱い
てんか	転か	抑制単語	転訛
てんぐすびょう	てんぐ巣病	抑制単語	天狗巣病
てんぐや	てんぐ屋	抑制単語	天狗屋
てんこく	てん刻	抑制単語	篆刻
てんさい	てん菜	抑制単語	甜菜
てんさいとう	てんさい糖	抑制単語	甜菜糖
てんさいとう	てん菜糖	抑制単語	甜菜糖
てんさいはわすれたころにやってくる	天災は忘れたころにやってくる	抑制単語	天災は忘れた頃にやって来る
てんし	展し	抑制単語	展翅
てんしんらんまん	天真らんまん	抑制単語	天真爛漫
てんばつてきめん	天罰てきめん	抑制単語	天罰覿面
てんびん	天びん	抑制単語	天秤
てんぷらそば	天ぷらそば	抑制単語	天ぷら蕎麦
てんまつ	てん末	抑制単語	顚末
てんまつ	てん末	抑制単語	顛末
であい	出あい	抑制単語	出逢い
であいつながる	出会いつながる	抑制単語	出会い繋がる
であいにつながっ	出会いにつながっ	抑制単語	出会いに繋がっ
であいにつながり	出会いにつながり	抑制単語	出会いに繋がり
であいにつながる	出会いにつながる	抑制単語	出会いに繋がる
であいにつながる	出会いにつながる	抑制単語	出逢いに繋がる
であう	出あう	抑制単語	出逢う
であえ	出あえ	抑制単語	出逢え
であえ	出あえ	抑制単語	出逢え
であえる	出あえる	抑制単語	出逢える
であっ	出あっ	抑制単語	出逢っ
であわ	出あわ	抑制単語	出逢わ
でがらし	出がらし	抑制単語	出涸らし
できあい	でき愛	抑制単語	溺愛
でそろい	出そろい	抑制単語	出揃い
でそろう	出そろう	抑制単語	出揃う
でそろえ	出そろえ	抑制単語	出揃え
でそろっ	出そろっ	抑制単語	出揃っ
でそろわ	出そろわ	抑制単語	出揃わ
でっちあげ	でっち上げ	抑制単語	捏ち上げ
でばなをくじい	出鼻をくじい	抑制単語	出鼻を挫い
でばなをくじか	出ばなをくじか	抑制単語	出端を挫か
でばなをくじか	出ばなをくじか	抑制単語	出鼻を挫か
でばなをくじか	出端をくじか	抑制単語	出端を挫か
でばなをくじか	出端をくじか	抑制単語	出鼻を挫か
でばなをくじか	出鼻をくじか	抑制単語	出端を挫か
でばなをくじか	出鼻をくじか	抑制単語	出鼻を挫か
でばなをくじく	出鼻をくじく	抑制単語	出鼻を挫く
でむかえ	出むかえ	抑制単語	出逢え
でむかえ	出向かえ	抑制単語	出逢え
でんどうくるまいす	電動車いす	抑制単語	電動車椅子
でんぱ	伝ぱ	抑制単語	伝播
でんぷん	でん粉	抑制単語	澱粉
でーたかいざん	データ改ざん	抑制単語	データ改竄
といあわせいただい	問い合わせいただい	抑制単語	問い合わせ戴い
といあわせいただき	問い合わせいただき	抑制単語	問い合わせ戴き
といあわせいただき	問合せいただき	抑制単語	問い合わせ戴き
とうかん	投かん	抑制単語	投函
とうがたち	とうが立ち	抑制単語	薹が立ち
とうがたっ	とうが立っ	抑制単語	薹が立っ
とうがらし	唐がらし	抑制単語	唐芥子
とうしょ	島しょ	抑制単語	島嶼
とうしょぶ	島しょ部	抑制単語	島嶼部
とうじすごい	当時すごい	抑制単語	当時凄い
とうじすごく	当時すごく	抑制単語	当時凄く
とうじものすごく	当時ものすごく	抑制単語	当時物凄く
とうせん	当せん	抑制単語	当籤
とうぜんうれしい	当然うれしい	抑制単語	当然嬉しい
とうぜんすごい	当然すごい	抑制単語	当然凄い
とうぜんものすごい	当然ものすごい	抑制単語	当然もの凄い
とうてき	投てき	抑制単語	投擲
とうや	陶や	抑制単語	陶冶
とうろう	灯ろう	抑制単語	灯篭
とうろう	灯ろう	抑制単語	灯籠
とおまわし	遠まわし	抑制単語	遠廻し
とおりいじっ	通りいじっ	抑制単語	通り弄っ
とおりしゃべっ	通りしゃべっ	抑制単語	通り喋っ
とおりすがり	通りすがり	抑制単語	通り縋り
とおりそろい	通りそろい	抑制単語	通り揃い
とおりそろう	通りそろう	抑制単語	通り揃う
とおりそろえ	通りそろえ	抑制単語	通り揃え
とおりそろえ	通りそろえ	抑制単語	通り揃え
とおりそろえる	通りそろえる	抑制単語	通り揃える
とおりそろっ	通りそろっ	抑制単語	通り揃っ
とおりでそろっ	通り出そろっ	抑制単語	通り出揃っ
とおりまわっ	通りまわっ	抑制単語	通り廻っ
ときいろ	とき色	抑制単語	鴇色
ときどきじぶん	ときどき自分	抑制単語	時々自分
ときどきとおく	ときどき遠く	抑制単語	時々遠く
ときどきにちじょう	ときどき日常	抑制単語	時々日常
ときのこえ	ときの声	抑制単語	鬨の声
とくべつすごい	特別すごい	抑制単語	特別凄い
とさつ	と殺	抑制単語	屠殺
としかさ	年かさ	抑制単語	年嵩
としこしそば	年越しそば	抑制単語	年越し蕎麦
としゃ	吐しゃ	抑制単語	吐瀉
としゃぶつ	吐しゃ物	抑制単語	吐瀉物
とじあな	とじ穴	抑制単語	綴じ穴
とじこま	とじ込ま	抑制単語	綴じ込ま
とじこみ	とじ込み	抑制単語	綴込み
とじこみ	とじ込み	抑制単語	綴じ込み
とじこむ	とじ込む	抑制単語	綴じ込む
とじこめ	とじ込め	抑制単語	綴じ込め
とじこもっ	閉じこもっ	抑制単語	閉じ篭もっ
とじこもっ	閉じこもっ	抑制単語	閉じ籠っ
とじこもっ	閉じこもっ	抑制単語	閉じ籠もっ
とじこもっ	閉じ込もっ	抑制単語	閉じ籠っ
とじこもり	閉じこもり	抑制単語	閉じ篭もり
とじこもり	閉じこもり	抑制単語	閉じ籠もり
とじこもり	閉じこもり	抑制単語	閉じ籠り
とじこもり	閉じ込もり	抑制単語	閉じ籠り
とじこもる	閉じこもる	抑制単語	閉じ篭もる
とじこもる	閉じこもる	抑制単語	閉じ籠もる
とじこもる	閉じこもる	抑制単語	閉じ籠る
とじこもる	閉じ込もる	抑制単語	閉じ籠る
とじこん	とじ込ん	抑制単語	綴じ込ん
とぜつ	と絶	抑制単語	杜絶
とそうはげ	塗装はげ	抑制単語	塗装剥げ
とそうはげ	塗装はげ	抑制単語	塗装禿げ
とちのき	とちの木	抑制単語	栃の木
とちのき	とちの木	抑制単語	橡の木
とつぜんかゆく	突然かゆく	抑制単語	突然痒く
とつぜんすごい	突然すごい	抑制単語	突然凄い
とつぜんすごく	突然すごく	抑制単語	突然凄く
とつぜんものすごい	突然ものすごい	抑制単語	突然もの凄い
とつぜんものすごい	突然ものすごい	抑制単語	突然物凄い
とてもかっこうよく	とても格好よく	抑制単語	とても恰好良く
とてもなじみぶかい	とてもなじみ深い	抑制単語	とても馴染み深い
とてもはがゆい	とても歯がゆい	抑制単語	とても歯痒い
とどろきわたる	とどろき渡る	抑制単語	轟き渡る
とにかくいま	とにかく今	抑制単語	兎に角今
とにかくじぶん	とにかく自分	抑制単語	兎に角自分
とびしょく	とび職	抑制単語	鳶職
とびまわっ	飛びまわっ	抑制単語	飛び廻っ
とびまわり	飛びまわり	抑制単語	飛び廻り
とびまわる	飛びまわる	抑制単語	飛び廻る
とふく	と腹	抑制単語	屠腹
とみくじ	富くじ	抑制単語	富籤
とらえかえす	とらえ返す	抑制単語	捉え返す
とらねこ	とら猫	抑制単語	虎猫
とらのまき	とらの巻	抑制単語	虎の巻
とりかご	鳥かご	抑制単語	鳥籠
とりがい	撮りがい	抑制単語	撮り甲斐
とりくみがい	取り組みがい	抑制単語	取り組み甲斐
とりこぼし	取りこぼし	抑制単語	取り溢し
とりこわし	取りこわし	抑制単語	取り毀し
とりざた	取りざた	抑制単語	取り沙汰
とりすがっ	取りすがっ	抑制単語	取り縋っ
とりすがる	取りすがる	抑制単語	取り縋る
とりそろえ	取りそろえ	抑制単語	取り揃え
とりそろえ	取りそろえ	抑制単語	取り揃え
とりそろえ	取りそろえ	抑制単語	取揃え
とりそろえる	取りそろえる	抑制単語	取り揃える
とりそろえる	取りそろえる	抑制単語	取揃える
とりため	取りため	抑制単語	取り溜め
とりため	撮りため	抑制単語	撮り溜め
とりため	撮りため	抑制単語	撮り溜め
とりため	録りため	抑制単語	録り溜め
とりためし	撮りためし	抑制単語	撮り溜めし
とりためる	撮りためる	抑制単語	撮り溜める
とりつい	取りつい	抑制単語	取り憑い
とりつか	取りつか	抑制単語	取り憑か
とりつかれ	執りつかれ	抑制単語	執り憑かれ
とりつかれ	獲りつかれ	抑制単語	獲り憑かれ
とりつかれ	取りつかれ	抑制単語	取り憑かれ
とりつかれ	取りつかれ	抑制単語	取り憑かれ
とりつかれる	取りつかれる	抑制単語	取り憑かれる
とりつき	取りつき	抑制単語	取り憑き
とりつき	取り付き	抑制単語	酉付き
とりつく	取りつく	抑制単語	取り憑く
とりつけ	取りつけ	抑制単語	取り憑け
とりつこ	取りつこ	抑制単語	取り憑こ
とりつこう	取りつこう	抑制単語	取り憑こう
とりつぶし	取りつぶし	抑制単語	取り潰し
とりまとめ	取りまとめ	抑制単語	取り纏め
とりまとめ	取りまとめ	抑制単語	取り纏め
とりまとめる	取りまとめる	抑制単語	取り纏める
とりまわし	取りまわし	抑制単語	取り廻し
とりもち	鳥もち	抑制単語	鳥黐
とれつ	と列	抑制単語	堵列
とんそう	とん走	抑制単語	遁走
とんぼだま	とんぼ玉	抑制単語	蜻蛉玉
どうかつ	どう喝	抑制単語	恫喝
どうくつ	洞くつ	抑制単語	洞窟
どうせい	同せい	抑制単語	同棲
どうちゃく	どう着	抑制単語	撞着
どうまわり	胴まわり	抑制単語	胴廻り
どうもう	どう猛	抑制単語	獰猛
どうもう	どう猛	抑制単語	獰猛
どうもく	どう目	抑制単語	瞠目
どとう	怒とう	抑制単語	怒涛
どとう	怒とう	抑制単語	怒濤
どなべ	土なべ	抑制単語	土鍋
どのう	土のう	抑制単語	土嚢
どのうぶくろ	土のう袋	抑制単語	土嚢袋
どんしょく	どん食	抑制単語	貪食
どんぶりかんじょう	どんぶり勘定	抑制単語	丼勘定
どんぶりや	どんぶり屋	抑制単語	丼屋
どんよく	どん欲	抑制単語	貪欲
どんよく	どん欲	抑制単語	貪欲
どんよくさ	どん欲さ	抑制単語	貪欲さ
なあて	名あて	抑制単語	名宛
ないしんうれしい	内心うれしい	抑制単語	内心嬉しい
ないていもらえ	内定もらえ	抑制単語	内定貰え
ないない	内ない	抑制単語	内々
ないぶひばく	内部被ばく	抑制単語	内部被曝
なかごろ	中ごろ	抑制単語	中頃
なかだるみ	中だるみ	抑制単語	中弛み
なかばあきらめ	半ばあきらめ	抑制単語	半ば諦め
なかばあきれ	半ばあきれ	抑制単語	半ば呆れ
なかばごろ	半ばごろ	抑制単語	半ば頃
なかふとう	中ふ頭	抑制単語	中埠頭
なかむつまじ	仲むつまじ	抑制単語	仲睦まじ
なかむつまじい	仲むつまじい	抑制単語	仲睦まじい
なかむつまじかっ	仲むつまじかっ	抑制単語	仲睦まじかっ
なかむつまじく	仲むつまじく	抑制単語	仲睦まじく
なかむつまじさ	仲むつまじさ	抑制単語	仲睦まじさ
なかむつまじそう	仲むつまじそう	抑制単語	仲睦まじそう
なかむら	中むら	抑制単語	中斑
ながいまつげ	長いまつげ	抑制単語	長い睫毛
ながじゅばん	長じゅばん	抑制単語	長襦袢
ながそで	長そで	抑制単語	長袖
ながなす	長なす	抑制単語	長茄子
ながねぎ	長ねぎ	抑制単語	長葱
ながれにつながる	流れにつながる	抑制単語	流れに繋がる
ながれにのま	流れにのま	抑制単語	流れに呑ま
ながれにもま	流れにもま	抑制単語	流れに揉ま
ながれぶったぎり	流れぶったぎり	抑制単語	流れぶった斬り
ながれをくむ	流れをくむ	抑制単語	流れを汲む
ながれをくん	流れをくん	抑制単語	流れを汲ん
なきぬれ	泣きぬれ	抑制単語	泣き濡れ
なきぬれる	泣きぬれる	抑制単語	泣き濡れる
なきはらし	泣きはらし	抑制単語	泣き腫らし
なきむせぶ	泣きむせぶ	抑制単語	泣き咽ぶ
なぎたおさ	なぎ倒さ	抑制単語	薙ぎ倒さ
なぎたおし	なぎ倒し	抑制単語	薙ぎ倒し
なぎたおす	なぎ倒す	抑制単語	薙ぎ倒す
なぎたおせる	なぎ倒せる	抑制単語	薙ぎ倒せる
なぎはらい	なぎ払い	抑制単語	薙ぎ払い
なぎはらう	なぎ払う	抑制単語	薙ぎ払う
なぎはらえ	なぎ払え	抑制単語	薙ぎ払え
なぎはらえ	なぎ払え	抑制単語	薙ぎ払え
なぎはらえる	なぎ払える	抑制単語	薙ぎ払える
なぎはらっ	なぎ払っ	抑制単語	薙ぎ払っ
なぎはらわ	なぎ払わ	抑制単語	薙ぎ払わ
なげやり	投げ遣り	抑制単語	投槍
なじみうすい	なじみ薄い	抑制単語	馴染み薄い
なじみがうすい	なじみが薄い	抑制単語	馴染みが薄い
なじみがうすかっ	なじみが薄かっ	抑制単語	馴染みが薄かっ
なじみがうすく	なじみが薄く	抑制単語	馴染みが薄く
なじみきゃく	なじみ客	抑制単語	馴染み客
なじみつかい	なじみ使い	抑制単語	馴染み使い
なじみぶかい	なじみ深い	抑制単語	馴染み深い
なじみぶかかっ	なじみ深かっ	抑制単語	馴染み深かっ
なじみぶかく	なじみ深く	抑制単語	馴染み深く
なじみぶかさ	なじみ深さ	抑制単語	馴染み深さ
なじみもち	なじみ持ち	抑制単語	馴染み持ち
なついん	なつ印	抑制単語	捺印
なつごろ	夏ごろ	抑制単語	夏頃
なつみかん	夏みかん	抑制単語	夏蜜柑
なつやせ	夏やせ	抑制単語	夏痩せ
なであらい	なで洗い	抑制単語	撫で洗い
なでおろし	なで下ろし	抑制単語	撫で下ろし
なでおろす	なで下ろす	抑制単語	撫で下ろす
なでがた	なで肩	抑制単語	撫で肩
なでまわし	なで回し	抑制単語	撫で回し
なでまわす	なで回す	抑制単語	撫で回す
ななくさがゆ	七草がゆ	抑制単語	七種粥
ななくさがゆ	七草がゆ	抑制単語	七草粥
ななじごろ	七時ごろ	抑制単語	七時頃
ななねんごろ	七年ごろ	抑制単語	七年頃
なによりうれしい	何よりうれしい	抑制単語	何より嬉しい
なによりうれしかっ	何よりうれしかっ	抑制単語	何より嬉しかっ
なによりうれしく	何よりうれしく	抑制単語	何より嬉しく
なによりすごい	何よりすごい	抑制単語	何より凄い
なによりすごかっ	何よりすごかっ	抑制単語	何より凄かっ
なによりすごく	何よりすごく	抑制単語	何より凄く
なぶりころさ	なぶり殺さ	抑制単語	嬲り殺さ
なぶりころし	なぶり殺し	抑制単語	嬲り殺し
なぶりころす	なぶり殺す	抑制単語	嬲り殺す
なぶりごろし	なぶり殺し	抑制単語	嬲り殺し
なべりょうり	なべ料理	抑制単語	鍋料理
なまあおのり	生青のり	抑制単語	生青海苔
なまあん	生あん	抑制単語	生餡
なまいちご	生いちご	抑制単語	生苺
なまかき	生かき	抑制単語	生柿
なまかき	生かき	抑制単語	生牡蛎
なまがき	生がき	抑制単語	生柿
なまくり	生くり	抑制単語	生栗
なまこかべ	なまこ壁	抑制単語	海鼠壁
なまさば	生さば	抑制単語	生鯖
なましいたけ	生しいたけ	抑制単語	生椎茸
なましょうが	生しょうが	抑制単語	生生姜
なまずわいがに	生ずわいがに	抑制単語	生ずわい蟹
なませっけん	生せっけん	抑制単語	生石鹸
なませっけん	生石けん	抑制単語	生石鹸
なまたこ	生たこ	抑制単語	生蛸
なまたまねぎ	生たまねぎ	抑制単語	生玉葱
なまたまねぎ	生玉ねぎ	抑制単語	生玉葱
なまたら	生たら	抑制単語	生鱈
なまつば	生つば	抑制単語	生唾
なまなましい	生なましい	抑制単語	生々しい
なまなましく	生なましく	抑制単語	生々しく
なまのり	生のり	抑制単語	生海苔
なまはちみつ	生はちみつ	抑制単語	生蜂蜜
なままぐろ	生まぐろ	抑制単語	生鮪
なまみそ	生みそ	抑制単語	生味噌
なまゆず	生ゆず	抑制単語	生柚子
なまわさび	生わさび	抑制単語	生山葵
なみだあふれ	涙あふれ	抑制単語	涙溢れ
なみだもろい	涙もろい	抑制単語	涙脆い
なみだもろく	涙もろく	抑制単語	涙脆く
なみだをのみ	涙をのみ	抑制単語	涙を呑み
なみだをのむ	涙をのむ	抑制単語	涙を呑む
なみだをのん	涙をのん	抑制単語	涙を呑ん
なめくさっ	なめ腐っ	抑制単語	舐め腐っ
なめつくし	なめ尽くし	抑制単語	嘗め尽くし
なめつくし	なめ尽くし	抑制単語	舐め尽くし
なめつくす	なめ尽くす	抑制単語	嘗め尽くす
なめつくす	なめ尽くす	抑制単語	舐め尽くす
なめまわし	なめ回し	抑制単語	嘗め回し
なめまわし	なめ回し	抑制単語	舐め回し
なめまわす	なめ回す	抑制単語	嘗め回す
なめまわす	なめ回す	抑制単語	舐め回す
なれあい	なれ合い	抑制単語	馴れ合い
なれあう	なれ合う	抑制単語	馴れ合う
なれあっ	なれ合っ	抑制単語	馴れ合っ
なれあわ	なれ合わ	抑制単語	馴れ合わ
なれしたしん	なれ親しん	抑制単語	馴れ親しん
なれそめ	なれ初め	抑制単語	馴れ初め
なれそめ	なれ初め	抑制単語	馴初め
なわのれん	縄のれん	抑制単語	縄暖簾
なわばしご	縄ばしご	抑制単語	縄梯子
なをはせ	名をはせ	抑制単語	名を馳せ
なをはせる	名をはせる	抑制単語	名を馳せる
なんこう	軟こう	抑制単語	軟膏
にあてはめて	に当てはめて	抑制単語	に当て嵌めて
にあふれでて	にあふれ出て	抑制単語	に溢れ出て
にいのちをかけて	に命をかけて	抑制単語	に命を賭けて
にいろあせて	に色あせて	抑制単語	に色褪せて
にえたぎっ	煮えたぎっ	抑制単語	煮え滾っ
にえたぎる	煮えたぎる	抑制単語	煮え滾る
においうつり	におい移り	抑制単語	匂い移り
においかぐ	臭いかぐ	抑制単語	臭い嗅ぐ
においきえ	におい消え	抑制単語	匂い消え
においけし	におい消し	抑制単語	匂い消し
においさくら	におい桜	抑制単語	匂い桜
においしみつい	におい染み付い	抑制単語	匂い染み付い
においただよう	におい漂う	抑制単語	匂い漂う
においたつ	におい立つ	抑制単語	匂い立つ
においとれ	におい取れ	抑制単語	匂い取れ
においにきづい	臭いに気づい	抑制単語	匂いに気付い
においぶくろ	におい袋	抑制単語	匂袋
にかきためて	に書きためて	抑制単語	に書き溜めて
にがつごろ	二月ごろ	抑制単語	2月頃
にがつごろ	二月ごろ	抑制単語	二月頃
にがむしをかみつぶし	苦虫をかみつぶし	抑制単語	苦虫を噛み潰し
にききほれて	に聞きほれて	抑制単語	に聞き惚れて
にぎりこぶし	握りこぶし	抑制単語	握り拳
にぎりつぶさ	握りつぶさ	抑制単語	握り潰さ
にぎりつぶさん	握りつぶさん	抑制単語	握り潰さん
にぎりつぶし	握りつぶし	抑制単語	握り潰し
にぎりつぶす	握りつぶす	抑制単語	握り潰す
にぎりつぶせ	握りつぶせ	抑制単語	握り潰せ
にぎりつぶそ	握りつぶそ	抑制単語	握り潰そ
にぎりつぶそう	握りつぶそう	抑制単語	握り潰そう
にくしゅ	肉しゅ	抑制単語	肉腫
にくまれっこよにはばかる	憎まれっ子世にはばかる	抑制単語	憎まれっ子世に憚る
にくみそ	肉みそ	抑制単語	肉味噌
にけた	二けた	抑制単語	二桁
にさばき	荷さばき	抑制単語	荷捌
にしんけいをとがらせて	に神経をとがらせて	抑制単語	に神経を尖らせて
にじごろ	二時ごろ	抑制単語	二時頃
にじみださ	にじみ出さ	抑制単語	滲み出さ
にじみだし	にじみ出し	抑制単語	滲み出し
にじみだす	にじみ出す	抑制単語	滲み出す
にじみで	にじみ出	抑制単語	滲み出
にじみで	にじみ出	抑制単語	滲み出
にじみでる	にじみ出る	抑制単語	滲み出る
にじりぐち	にじり口	抑制単語	躙口
にそくのわらじをはい	二足のわらじをはい	抑制単語	二足の草鞋を履い
にそくのわらじをはい	二足のわらじを履い	抑制単語	二足の草鞋を履い
にそくのわらじをはき	二足のわらじを履き	抑制単語	二足の草鞋を履き
にそくのわらじをはく	二足のわらじをはく	抑制単語	二足の草鞋を履く
にそくのわらじをはく	二足のわらじを履く	抑制単語	二足の草鞋を履く
にとりつかれて	に取りつかれて	抑制単語	に取り憑かれて
にねんごろ	二年ごろ	抑制単語	二年頃
にばんせんじ	二番せんじ	抑制単語	二番煎じ
にまきちらして	にまき散らして	抑制単語	に撒き散らして
にみちあふれて	に満ちあふれて	抑制単語	に満ち溢れて
にゅうがん	乳がん	抑制単語	乳癌
にゅうろう	入ろう	抑制単語	入牢
にらみあい	にらみ合い	抑制単語	睨み合い
にらみあいし	にらみ合いし	抑制単語	睨み合いし
にらみあう	にらみ合う	抑制単語	睨み合う
にらみあっ	にらみ合っ	抑制単語	睨み合っ
にらみかえし	にらみ返し	抑制単語	睨み返し
にらみかえす	にらみ返す	抑制単語	睨み返す
にらみきか	にらみ効か	抑制単語	睨み効か
にらみつけ	にらみ付け	抑制単語	睨み付け
にらみつける	にらみ付ける	抑制単語	睨み付ける
にわとりひきにく	鶏ひき肉	抑制単語	鶏挽肉
にんきすご	人気すご	抑制単語	人気凄
にんきすごい	人気すごい	抑制単語	人気凄い
にんきすごかっ	人気すごかっ	抑制単語	人気凄かっ
ぬいつない	縫いつない	抑制単語	縫い繋い
ぬいつなげ	縫いつなげ	抑制単語	縫い繋げ
ぬいとじ	縫いとじ	抑制単語	縫い綴じ
ぬかずけ	ぬか漬	抑制単語	糠漬
ぬかずけ	ぬか漬	抑制単語	糠漬け
ぬかづけ	ぬか漬	抑制単語	糠漬
ぬかづけ	ぬか漬	抑制単語	糠漬け
ぬかどこ	ぬか床	抑制単語	糠床
ぬぎはき	脱ぎはき	抑制単語	脱ぎ穿き
ぬくもりあふれ	温もりあふれ	抑制単語	温もり溢れ
ぬくもりあふれる	温もりあふれる	抑制単語	温もり溢れる
ぬくもりにあふれ	温もりにあふれ	抑制単語	温もりに溢れ
ぬぐいえき	ぬぐい液	抑制単語	拭い液
ぬぐいおとし	ぬぐい落とし	抑制単語	拭い落とし
ぬぐいさっ	ぬぐい去っ	抑制単語	拭い去っ
ぬぐいさら	ぬぐい去ら	抑制単語	拭い去ら
ぬぐいさり	ぬぐい去り	抑制単語	拭い去り
ぬぐいさる	ぬぐい去る	抑制単語	拭い去る
ぬぐいされ	ぬぐい去れ	抑制単語	拭い去れ
ぬぐいされ	ぬぐい去れ	抑制単語	拭い去れ
ぬぐいさろ	ぬぐい去ろ	抑制単語	拭い去ろ
ぬぐいとっ	ぬぐい取っ	抑制単語	拭い取っ
ぬぐいとり	ぬぐい取り	抑制単語	拭い取り
ぬぐいとる	ぬぐい取る	抑制単語	拭い取る
ぬぐいにくい	ぬぐい難い	抑制単語	拭い難い
ぬすっとたけだけしい	盗人たけだけしい	抑制単語	盗っ人猛々しい
ぬすっとたけだけしい	盗人たけだけしい	抑制単語	盗人猛々しい
ぬりがい	塗りがい	抑制単語	塗り甲斐
ぬりこめ	塗りこめ	抑制単語	塗り籠め
ぬりつぶさ	塗りつぶさ	抑制単語	塗り潰さ
ぬりつぶし	塗りつぶし	抑制単語	塗り潰し
ぬりつぶす	塗りつぶす	抑制単語	塗り潰す
ぬりつぶせ	塗りつぶせ	抑制単語	塗り潰せ
ぬりつぶせ	塗りつぶせ	抑制単語	塗り潰せ
ぬりつぶそ	塗りつぶそ	抑制単語	塗り潰そ
ぬりつぶそう	塗りつぶそう	抑制単語	塗り潰そう
ぬれぎぬをきせ	ぬれぎぬを着せ	抑制単語	濡れ衣を着せ
ぬれぎぬをきせ	ぬれぎぬを着せ	抑制単語	濡れ衣を着せ
ねがいかない	願いかない	抑制単語	願い叶い
ねがいかなう	願いかなう	抑制単語	願い叶う
ねがいかなえ	願いかなえ	抑制単語	願い叶え
ねがいかなえる	願いかなえる	抑制単語	願い叶える
ねがいかなっ	願いかなっ	抑制単語	願い叶っ
ねがいかなわ	願いかなわ	抑制単語	願い叶わ
ねくびをかか	寝首をかか	抑制単語	寝首を掻か
ねこだまし	猫だまし	抑制単語	猫騙し
ねこなでごえ	ねこなで声	抑制単語	猫撫で声
ねこなでごえ	猫なで声	抑制単語	猫撫で声
ねじきっ	ねじ切っ	抑制単語	捩じ切っ
ねじこま	ねじ込ま	抑制単語	捩じ込ま
ねじこみ	ねじ込み	抑制単語	捩じ込み
ねじこむ	ねじ込む	抑制単語	捩じ込む
ねじこん	ねじ込ん	抑制単語	捩じ込ん
ねじふせ	ねじ伏せ	抑制単語	捩じ伏せ
ねじふせ	ねじ伏せ	抑制単語	捻じ伏せ
ねじふせ	ねじ伏せ	抑制単語	捩じ伏せ
ねじふせ	ねじ伏せ	抑制単語	捻じ伏せ
ねじふせる	ねじ伏せる	抑制単語	捩じ伏せる
ねじふせる	ねじ伏せる	抑制単語	捻じ伏せる
ねじまげ	ねじ曲げ	抑制単語	捻じ曲げ
ねじまげ	ねじ曲げ	抑制単語	捩じ曲げ
ねじまげ	ねじ曲げ	抑制単語	捻じ曲げ
ねじまげよ	ねじ曲げよ	抑制単語	捻じ曲げよ
ねじまげる	ねじ曲げる	抑制単語	捩じ曲げる
ねじまげる	ねじ曲げる	抑制単語	捻じ曲げる
ねじりこみ	ねじり込み	抑制単語	捻り込み
ねじりこむ	ねじり込む	抑制単語	捻り込む
ねじりこん	ねじり込ん	抑制単語	捻り込ん
ねずみいろ	ねずみ色	抑制単語	鼠色
ねずみざん	ねずみ算	抑制単語	鼠算
ねっせいけいれん	熱性けいれん	抑制単語	熱性痙攣
ねつぞう	ねつ造	抑制単語	捏造
ねとぼけ	寝とぼけ	抑制単語	寝惚け
ねぼけ	寝ぼけ	抑制単語	寝呆け
ねぼけ	寝ぼけ	抑制単語	寝惚け
ねぼけめ	寝ぼけ眼	抑制単語	寝惚け眼
ねぼける	寝ぼける	抑制単語	寝惚ける
ねらいうち	ねらい打ち	抑制単語	狙い打ち
ねらいうち	ねらい撃ち	抑制単語	狙い撃ち
ねらいうちし	ねらい打ちし	抑制単語	狙い打ちし
ねらいうちする	ねらい打ちする	抑制単語	狙い打ちする
ねらいさだめ	ねらい定め	抑制単語	狙い定め
ねらいどおり	ねらい通り	抑制単語	狙い通り
ねらいめだっ	ねらい目だっ	抑制単語	狙い目だっ
ねりせいひん	練り製品	抑制単語	煉製品
ねんがんかない	念願かない	抑制単語	念願叶い
ねんしゅつ	ねん出	抑制単語	捻出
ねんてん	ねん転	抑制単語	捻転
ねんまつごろ	年末ごろ	抑制単語	年末頃
のいちご	野いちご	抑制単語	野苺
のういっけつ	脳いっ血	抑制単語	脳溢血
のうこうぎょかいつけめん	濃厚魚介つけめん	抑制単語	濃厚魚介つけ麺
のうこうそく	脳こうそく	抑制単語	脳硬塞
のうさぎ	野うさぎ	抑制単語	野兎
のうしゅよう	脳しゅよう	抑制単語	脳腫瘍
のうしんとう	脳しんとう	抑制単語	脳震盪
のうしんとう	脳震とう	抑制単語	脳震盪
のうせいまひ	脳性まひ	抑制単語	脳性麻痺
のうほう	のう胞	抑制単語	嚢胞
のうほう	のう胞	抑制単語	囊胞
のうみそ	脳みそ	抑制単語	脳味噌
のざらし	野ざらし	抑制単語	野晒
のしがみ	のし紙	抑制単語	熨斗紙
のしぶくろ	のし袋	抑制単語	熨斗袋
のしをつけ	のしを付け	抑制単語	熨斗を付け
のぞきあな	のぞき穴	抑制単語	覗き穴
のぞきいわ	のぞき岩	抑制単語	覗き岩
のぞきこま	のぞき込ま	抑制単語	覗き込ま
のぞきこみ	のぞき込み	抑制単語	覗き込み
のぞきこむ	のぞき込む	抑制単語	覗き込む
のぞきこめ	のぞき込め	抑制単語	覗き込め
のぞきこめる	のぞき込める	抑制単語	覗き込める
のぞきこも	のぞき込も	抑制単語	覗き込も
のぞきこん	のぞき込ん	抑制単語	覗き込ん
のぞきにいき	のぞきに行き	抑制単語	覗きに行き
のぞきにいく	のぞきに行く	抑制単語	覗きに行く
のぞきにいっ	のぞきに行っ	抑制単語	覗きに行っ
のぞきにき	のぞきに来	抑制単語	覗きに来
のぞきほうだい	のぞき放題	抑制単語	覗き放題
のぞきま	のぞき魔	抑制単語	覗き魔
のぞきまど	のぞき窓	抑制単語	覗き窓
のぞきみ	のぞき見	抑制単語	覗き見
のぞきみ	のぞき見	抑制単語	覗き見
のぞきみえ	のぞき見え	抑制単語	覗き見え
のぞきみえる	のぞき見える	抑制単語	覗き見える
のぞきみさ	のぞき見さ	抑制単語	覗き見さ
のぞきみし	のぞき見し	抑制単語	覗き見し
のぞきみする	のぞき見する	抑制単語	覗き見する
のぞきみよ	のぞき見よ	抑制単語	覗き見よ
のぞきみる	のぞき見る	抑制単語	覗き見る
のぞみかなえ	望みかなえ	抑制単語	望み叶え
のぞみつなぐ	望みつなぐ	抑制単語	望み繋ぐ
のぞみにかけ	望みにかけ	抑制単語	望みに賭け
のちずり	後刷り	抑制単語	後摺
のどいたい	のど痛い	抑制単語	喉痛い
のどからてがで	のどから手が出	抑制単語	喉から手が出
のどからてがでる	のどから手が出る	抑制単語	喉から手が出る
のどがかわい	のどが乾い	抑制単語	喉が乾い
のどがかわい	のどが渇い	抑制単語	喉が渇い
のどがかわか	のどが乾か	抑制単語	喉が乾か
のどがかわか	のどが渇か	抑制単語	喉が渇か
のどがかわき	のどが乾き	抑制単語	喉が乾き
のどがかわき	のどが渇き	抑制単語	喉が渇き
のどがかわきやすい	のどが乾きやすい	抑制単語	喉が乾きやすい
のどがかわきやすい	のどが渇きやすい	抑制単語	喉が渇きやすい
のどがかわきやすく	のどが渇きやすく	抑制単語	喉が渇きやすく
のどがかわく	のどが渇く	抑制単語	喉が渇く
のどがかわけ	のどが渇け	抑制単語	喉が渇け
のどぶえ	のど笛	抑制単語	喉笛
のどもと	のど元	抑制単語	喉元
のどもとすぎればあつさわすれる	のど元過ぎれば熱さ忘れる	抑制単語	喉元過ぎれば熱さ忘れる
のどもとすぎればあつさをわすれる	のど元過ぎれば熱さを忘れる	抑制単語	喉元過ぎれば熱さを忘れる
のどわ	のど輪	抑制単語	喉輪
のねずみ	野ねずみ	抑制単語	野鼠
のばら	野ばら	抑制単語	野薔薇
のぼりがい	登りがい	抑制単語	登り甲斐
のみこま	のみ込ま	抑制単語	呑み込ま
のみこみ	のみ込み	抑制単語	呑み込み
のみこみ	飲み込み	抑制単語	呑込み
のみこむ	のみ込む	抑制単語	呑み込む
のみこも	のみ込も	抑制単語	呑み込も
のみこん	のみ込ん	抑制単語	呑み込ん
のみすけ	飲み助	抑制単語	呑助
のみつぶれ	飲みつぶれ	抑制単語	飲み潰れ
のみにでかけ	飲みに出かけ	抑制単語	呑みに出掛け
のみのいち	のみの市	抑制単語	蚤の市
のみや	飲み屋	抑制単語	呑屋
のりこえ	のり越え	抑制単語	乘り越え
のりつぶさ	乗りつぶさ	抑制単語	乗り潰さ
のりつぶし	乗りつぶし	抑制単語	乗り潰し
のりつぶす	乗りつぶす	抑制単語	乗り潰す
のりつぶそ	乗りつぶそ	抑制単語	乗り潰そ
のりつぶそう	乗りつぶそう	抑制単語	乗り潰そう
のりなれ	乗りなれ	抑制単語	乗り馴れ
のりなれ	乗りなれ	抑制単語	乗り馴れ
のりのこり	のり残り	抑制単語	糊残り
のりまき	のり巻き	抑制単語	海苔巻き
のりまき	のり巻き	抑制単語	海苔巻き
のりまき	ノリ巻き	抑制単語	海苔巻
のりまわし	乗りまわし	抑制単語	乗り廻し
のれんわけ	のれん分け	抑制単語	暖簾分け
のれんわけ	のれん分け	抑制単語	暖簾分け
のんべえ	飲ん兵衛	抑制単語	呑兵衛
はいあがっ	はい上がっ	抑制単語	這い上がっ
はいあがら	はい上がら	抑制単語	這い上がら
はいあがり	はい上がり	抑制単語	這い上がり
はいあがる	はい上がる	抑制単語	這い上がる
はいあがれ	はい上がれ	抑制単語	這い上がれ
はいあがれる	はい上がれる	抑制単語	這い上がれる
はいあがろ	はい上がろ	抑制単語	這い上がろ
はいが	はい芽	抑制単語	胚芽
はいがん	肺がん	抑制単語	肺癌
はいずりまわっ	はいずり回っ	抑制単語	這いずり回っ
はいずりまわる	はいずり回る	抑制単語	這いずり回る
はいせつ	排せつ	抑制単語	排泄
はいせん	肺せん	抑制単語	肺尖
はいぜん	配ぜん	抑制単語	配膳
はいだし	はい出し	抑制単語	這い出し
はいだす	はい出す	抑制単語	這い出す
はいち	背ち	抑制単語	背馳
はいで	はい出	抑制単語	這い出
はいでる	はい出る	抑制単語	這い出る
はいまわっ	はい回っ	抑制単語	這い回っ
はいまわり	はい回り	抑制単語	這い回り
はいまわる	はい回る	抑制単語	這い回る
はいよう	はい用	抑制単語	佩用
はえそろい	生えそろい	抑制単語	生え揃い
はえそろう	生えそろう	抑制単語	生え揃う
はえそろっ	生えそろっ	抑制単語	生え揃っ
はえそろわ	生えそろわ	抑制単語	生え揃わ
はがしあと	はがし跡	抑制単語	剥がし跡
はがしとっ	はがし取っ	抑制単語	剥がし取っ
はがしとり	はがし取り	抑制単語	剥がし取り
はがしとる	はがし取る	抑制単語	剥がし取る
はがしのこし	はがし残し	抑制単語	剥がし残し
はがしわすれ	はがし忘れ	抑制単語	剥がし忘れ
はがゆい	歯がゆい	抑制単語	歯痒い
はがゆかっ	歯がゆかっ	抑制単語	歯痒かっ
はがゆく	歯がゆく	抑制単語	歯痒く
はがゆさ	歯がゆさ	抑制単語	歯痒さ
はがれおち	はがれ落ち	抑制単語	剥がれ落ち
はがれおち	はがれ落ち	抑制単語	剥がれ落ち
はがれおちる	はがれ落ちる	抑制単語	剥がれ落ちる
はきくらべ	はき比べ	抑制単語	穿き比べ
はきこみ	はき込み	抑制単語	穿き込み
はきこむ	はき込む	抑制単語	穿き込む
はきこん	はき込ん	抑制単語	穿き込ん
はきつぶさ	履きつぶさ	抑制単語	履き潰さ
はきつぶし	履きつぶし	抑制単語	履き潰し
はきつぶす	履きつぶす	抑制単語	履き潰す
はきつぶせる	履きつぶせる	抑制単語	履き潰せる
はきつぶそう	履きつぶそう	抑制単語	履き潰そう
はきつぶれ	履きつぶれ	抑制単語	履き潰れ
はきならし	履きならし	抑制単語	履き馴らし
はきなれ	はき慣れ	抑制単語	穿き慣れ
はきなれ	履きなれ	抑制単語	履き馴れ
はきわすれ	はき忘れ	抑制単語	穿き忘れ
はぎあわせ	はぎ合わせ	抑制単語	剥ぎ合わせ
はぎあわせ	はぎ合わせ	抑制単語	矧ぎ合わせ
はぎおとし	はぎ落とし	抑制単語	剥ぎ落とし
はぎしり	歯ぎしり	抑制単語	歯軋り
はぎとっ	はぎ取っ	抑制単語	剥ぎ取っ
はぎとら	はぎ取ら	抑制単語	剥ぎ取ら
はぎとり	はぎ取り	抑制単語	剝ぎ取り
はぎとり	はぎ取り	抑制単語	剥ぎ取り
はぎとる	はぎ取る	抑制単語	剥ぎ取る
はぎとろ	はぎ取ろ	抑制単語	剥ぎ取ろ
はくしゅかっさい	拍手喝さい	抑制単語	拍手喝采
はくせい	はく製	抑制単語	剝製
はくせい	はく製	抑制単語	剥製
はくせん	白せん	抑制単語	白癬
はくそ	歯くそ	抑制単語	歯糞
はくだつ	はく奪	抑制単語	剝奪
はくだつ	はく奪	抑制単語	剥奪
はくらく	はく落	抑制単語	剝落
はくらく	はく落	抑制単語	剥落
はくり	はく離	抑制単語	剝離
はくり	はく離	抑制単語	剥離
はけぐち	はけ口	抑制単語	捌け口
はげあがっ	はげ上がっ	抑制単語	禿げ上がっ
はげあがり	はげ上がり	抑制単語	禿げ上がり
はげあがる	はげ上がる	抑制単語	禿げ上がる
はげあたま	はげ頭	抑制単語	禿頭
はげおち	はげ落ち	抑制単語	剥げ落ち
はげおちる	はげ落ちる	抑制単語	剥げ落ちる
はげちらかし	はげ散らかし	抑制単語	禿げ散らかし
はげちらかし	はげ散らかし	抑制単語	禿散らかし
はげやま	はげ山	抑制単語	禿山
はこつぶれ	箱つぶれ	抑制単語	箱潰れ
はしげた	橋げた	抑制単語	橋桁
はしごだん	はしご段	抑制単語	梯子段
はしごのり	はしご乗り	抑制単語	梯子乗り
はしごをはずされ	はしごを外され	抑制単語	梯子を外され
はしごをはずされる	はしごを外される	抑制単語	梯子を外される
はしゅ	は種	抑制単語	播種
はしりがい	走りがい	抑制単語	走り甲斐
はしりつない	走りつない	抑制単語	走り繋い
はしりまわっ	走りまわっ	抑制単語	走り廻っ
はしりまわり	走りまわり	抑制単語	走り廻り
はしりまわる	走りまわる	抑制単語	走り廻る
はしりまわれる	走りまわれる	抑制単語	走り廻れる
はじさらし	恥さらし	抑制単語	恥曝し
はじめごろ	初めごろ	抑制単語	初め頃
はじめごろ	始めごろ	抑制単語	始め頃
はせさんじ	はせ参じ	抑制単語	馳せ参じ
はせさんじる	はせ参じる	抑制単語	馳せ参じる
はたちのころ	二十歳のころ	抑制単語	二十歳の頃
はたん	破たん	抑制単語	破綻
はだきれい	肌きれい	抑制単語	肌綺麗
はだなじみ	肌なじみ	抑制単語	肌馴染み
はだなじみ	肌なじみ	抑制単語	肌馴染み
はちがつごろ	八月ごろ	抑制単語	8月頃
はちがつごろ	八月ごろ	抑制単語	八月頃
はちじごろ	八時ごろ	抑制単語	八時頃
はちじはんごろ	八時半ごろ	抑制単語	八時半頃
はちねんごろ	八年ごろ	抑制単語	八年頃
はちのす	はちの巣	抑制単語	蜂の巣
はちみつづけ	はちみつ漬け	抑制単語	蜂蜜漬け
はちみつづけ	はちみつ漬け	抑制単語	蜂蜜漬け
はちゅうるい	はちゅう類	抑制単語	爬虫類
はちゅうるい	は虫類	抑制単語	爬虫類
はっこう	はっ酵	抑制単語	醗酵
はっこう	はっ酵	抑制単語	醱酵
はっしん	発しん	抑制単語	発疹
はってほしい	はって欲しい	抑制単語	貼って欲しい
はつがん	発がん	抑制単語	発癌
はつがんせい	発がん性	抑制単語	発癌性
はつとり	初採り	抑制単語	初酉
はつもうで	初もうで	抑制単語	初詣
はてにたどりつい	果てにたどり着い	抑制単語	果てに辿り着い
はとむぎ	はと麦	抑制単語	鳩麦
はなかご	花かご	抑制単語	花篭
はなかご	花かご	抑制単語	花籠
はなかんざし	花かんざし	抑制単語	花簪
はながつお	花がつお	抑制単語	花鰹
はなくそ	鼻くそ	抑制単語	鼻糞
はなしか	はなし家	抑制単語	咄家
はなしか	はなし家	抑制単語	噺家
はなしすごい	話すごい	抑制単語	話凄い
はなしすごく	話すごく	抑制単語	話凄く
はなしょうぶ	花しょうぶ	抑制単語	花菖蒲
はなたかだか	鼻たかだか	抑制単語	鼻高々
はなやぎあふれる	華やぎあふれる	抑制単語	華やぎ溢れる
はねあげ	はね上げ	抑制単語	撥ね上げ
はねあげる	はね上げる	抑制単語	撥ね上げる
はねかえさ	はね返さ	抑制単語	撥ね返さ
はねかえし	はね返し	抑制単語	撥ね返し
はねかえす	はね返す	抑制単語	撥ね返す
はねとばさ	はね飛ばさ	抑制単語	撥ね飛ばさ
はねとばし	はね飛ばし	抑制単語	刎ね飛ばし
はねとばし	はね飛ばし	抑制単語	撥ね飛ばし
はねとばす	はね飛ばす	抑制単語	撥ね飛ばす
はねのけ	はね退け	抑制単語	撥ね退け
はねのぞけ	はね除け	抑制単語	撥ね除け
はばひろいしなぞろえ	幅広い品ぞろえ	抑制単語	幅広い品揃え
はぼたん	葉ぼたん	抑制単語	葉牡丹
はまゆで	浜ゆで	抑制単語	浜茹で
はまりこみ	はまり込み	抑制単語	嵌まり込み
はまりこむ	はまり込む	抑制単語	嵌まり込む
はまりこん	はまり込ん	抑制単語	嵌まり込ん
はまりやく	はまり役	抑制単語	嵌り役
はめあわせ	はめ合わせ	抑制単語	嵌め合わせ
はめこま	はめ込ま	抑制単語	填め込ま
はめこま	はめ込ま	抑制単語	嵌め込ま
はめこみ	はめ込み	抑制単語	嵌め込み
はめこみ	はめ込み	抑制単語	填め込み
はめこみ	はめ込み	抑制単語	嵌め込み
はめこみし	はめ込みし	抑制単語	嵌め込みし
はめこむ	はめ込む	抑制単語	填め込む
はめこむ	はめ込む	抑制単語	嵌め込む
はめこめ	はめ込め	抑制単語	嵌め込め
はめこめ	はめ込め	抑制単語	嵌め込め
はめこめ	はめ込め	抑制単語	嵌め込め
はめこめる	はめ込める	抑制単語	嵌め込める
はめこも	はめ込も	抑制単語	嵌め込も
はめころさ	はめ殺さ	抑制単語	嵌め殺さ
はめころし	はめ殺し	抑制単語	嵌め殺し
はめころしまど	はめ殺し窓	抑制単語	嵌め殺し窓
はめこん	はめ込ん	抑制単語	填め込ん
はめこん	はめ込ん	抑制単語	嵌め込ん
はめごろさ	はめ殺さ	抑制単語	嵌め殺さ
はめごろし	はめ殺し	抑制単語	嵌め殺し
はやしたて	はやし立て	抑制単語	囃し立て
はやしたて	はやし立て	抑制単語	囃し立て
はやしたてる	はやし立てる	抑制単語	囃し立てる
はらばい	腹ばい	抑制単語	腹這い
はりあげ	はり上げ	抑制単語	貼り上げ
はりあわせ	張り合わせ	抑制単語	貼り合せ
はりおわり	張り終わり	抑制単語	貼り終り
はりがみ	張り紙	抑制単語	貼紙
はりちりょう	はり治療	抑制単語	鍼治療
はりつけ	張り付け	抑制単語	貼付け
はりめぐらさ	はり巡らさ	抑制単語	貼り巡らさ
はるかいぜん	はるか以前	抑制単語	遥か以前
はるかおおむかし	はるか大昔	抑制単語	遥か大昔
はるかかこ	はるか過去	抑制単語	遥か過去
はるかかなた	はるか彼方	抑制単語	遥か彼方
はるかじょう	はるか上	抑制単語	遥か上
はるかたいこ	はるか太古	抑制単語	遥か太古
はるかとおい	はるか遠い	抑制単語	遥か遠い
はるかとおく	はるか遠く	抑制単語	遥か遠く
はるかとおく	はるか遠く	抑制単語	遥か遠く
はるかどおい	はるか遠い	抑制単語	遥か遠い
はるかどおく	はるか遠く	抑制単語	遥か遠く
はるかまえ	はるか前	抑制単語	遥か前
はるかむかし	はるか昔	抑制単語	遥か昔
はるかむかし	はるか昔	抑制単語	遥か昔
はるがすみ	春がすみ	抑制単語	春霞
はるごろ	春ごろ	抑制単語	春頃
はればれ	晴ばれ	抑制単語	晴々
はればれ	晴れ晴れ	抑制単語	晴々
はれもの	はれ物	抑制単語	腫れ物
はれもの	はれ物	抑制単語	腫物
はんえり	半えり	抑制単語	半衿
はんがんびいき	判官びいき	抑制単語	判官贔屓
はんごう	飯ごう	抑制単語	飯盒
はんすう	反すう	抑制単語	反芻
はんそで	半そで	抑制単語	半袖
はんそでしゃつ	半そでシャツ	抑制単語	半袖シャツ
はんちゅう	範ちゅう	抑制単語	範疇
はんつき	半つき	抑制単語	半搗
はんつや	半つや	抑制単語	半艶
はんばく	反ばく	抑制単語	反駁
はんぱつ	反ぱつ	抑制単語	反撥
はんぶんあきらめ	半分あきらめ	抑制単語	半分諦め
はんよう	はん用	抑制単語	汎用
はんらん	はん濫	抑制単語	氾濫
ばあいすごい	場合すごい	抑制単語	場合凄い
ばあいすごく	場合すごく	抑制単語	場合凄く
ばいえん	ばい煙	抑制単語	煤煙
ばいきん	ばい菌	抑制単語	黴菌
ばかさわぎ	ばか騒ぎ	抑制単語	馬鹿騒ぎ
ばかじから	ばか力	抑制単語	馬鹿力
ばかたかい	ばか高い	抑制単語	馬鹿高い
ばかたかく	ばか高く	抑制単語	馬鹿高く
ばかぢから	ばか力	抑制単語	馬鹿力
ばくしん	ばく進	抑制単語	驀進
ばくだい	ばく大	抑制単語	莫大
ばくだい	ばく大	抑制単語	莫大
ばけのかわがはがれ	化けの皮がはがれ	抑制単語	化けの皮が剥がれ
ばけのかわがはがれる	化けの皮がはがれる	抑制単語	化けの皮が剥がれる
ばけのかわをはがさ	化けの皮をはがさ	抑制単語	化けの皮を剥がさ
ばけのかわをはがし	化けの皮をはがし	抑制単語	化けの皮を剥がし
ばけのかわをはがす	化けの皮をはがす	抑制単語	化けの皮を剥がす
ばしのぎ	場しのぎ	抑制単語	場凌ぎ
ばしょふさぎ	場所ふさぎ	抑制単語	場所塞ぎ
ばせい	ば声	抑制単語	罵声
ばってき	抜てき	抑制単語	抜擢
ばってほしい	ばって欲しい	抑制単語	貼って欲しい
ばとう	ば倒	抑制単語	罵倒
ばふん	馬ふん	抑制単語	馬糞
ばらいろ	ばら色	抑制単語	薔薇色
ばらのそうれつ	ばらの葬列	抑制単語	薔薇の葬列
ばんかい	ばん回	抑制単語	挽回
ひあぶり	火あぶり	抑制単語	火炙り
ひあぶり	火あぶり	抑制単語	火焙り
ひいきめ	ひいき目	抑制単語	贔屓目
ひいきや	ひいき屋	抑制単語	贔屓屋
ひうちいし	火打ち石	抑制単語	燧石
ひおこし	火起こし	抑制単語	火熾し
ひからび	干からび	抑制単語	干涸らび
ひかりあふれる	光りあふれる	抑制単語	光り溢れる
ひがみおつ	ひがみ乙	抑制単語	僻み乙
ひがみこんじょう	ひがみ根性	抑制単語	僻み根性
ひがん	非がん	抑制単語	非癌
ひがんせい	非がん性	抑制単語	非癌性
ひきあげ	ひき上げ	抑制単語	挽き上げ
ひきあげ	ひき上げ	抑制単語	曳き上げ
ひきあわせ	ひき合わせ	抑制単語	曳き合わせ
ひきいれ	ひき入れ	抑制単語	挽き入れ
ひきいれ	ひき入れ	抑制単語	曳き入れ
ひきおこし	引き起こし	抑制単語	惹き起し
ひきおこす	引き起こす	抑制単語	惹き起す
ひきこま	ひき込ま	抑制単語	惹き込ま
ひきこもっ	引きこもっ	抑制単語	引き篭っ
ひきこもっ	引きこもっ	抑制単語	引き篭もっ
ひきこもっ	引きこもっ	抑制単語	引き籠っ
ひきこもっ	引きこもっ	抑制単語	引き籠もっ
ひきこもら	引きこもら	抑制単語	引き篭もら
ひきこもら	引きこもら	抑制単語	引き籠もら
ひきこもり	引きこもり	抑制単語	引き篭もり
ひきこもり	引きこもり	抑制単語	引き篭り
ひきこもり	引きこもり	抑制単語	引き籠もり
ひきこもり	引きこもり	抑制単語	引き籠り
ひきこもりがち	引きこもりがち	抑制単語	引き篭もりがち
ひきこもりがち	引きこもりがち	抑制単語	引き籠りがち
ひきこもりになっ	引きこもりになっ	抑制単語	引き篭もりになっ
ひきこもりになっ	引きこもりになっ	抑制単語	引き籠りになっ
ひきこもりになる	引きこもりになる	抑制単語	引き篭もりになる
ひきこもる	引きこもる	抑制単語	引き篭もる
ひきこもる	引きこもる	抑制単語	引き篭る
ひきこもる	引きこもる	抑制単語	引き籠もる
ひきこもる	引きこもる	抑制単語	引き籠る
ひきこもれる	引きこもれる	抑制単語	引き篭もれる
ひきこもろ	引きこもろ	抑制単語	引き篭もろ
ひきこもろう	引きこもろう	抑制単語	引き篭もろう
ひきこもろう	引きこもろう	抑制単語	引き篭ろう
ひきこもろう	引きこもろう	抑制単語	引き籠ろう
ひきころさ	ひき殺さ	抑制単語	轢き殺さ
ひきころし	ひき殺し	抑制単語	轢き殺し
ひきころす	ひき殺す	抑制単語	轢き殺す
ひきころせ	ひき殺せ	抑制単語	轢き殺せ
ひきころせ	ひき殺せ	抑制単語	轢き殺せ
ひきころせる	ひき殺せる	抑制単語	轢き殺せる
ひきころそ	ひき殺そ	抑制単語	轢き殺そ
ひきこん	ひき込ん	抑制単語	惹き込ん
ひきずっ	引きずっ	抑制単語	引き摺っ
ひきずら	引きずら	抑制単語	引き摺ら
ひきずり	引きずり	抑制単語	引き摺り
ひきずりおとし	引きずり落とし	抑制単語	引き摺り落とし
ひきずりおろさ	引きずり下ろさ	抑制単語	引き摺り下ろさ
ひきずりおろさ	引きずり下ろさ	抑制単語	引き摺り降ろさ
ひきずりおろさ	引きずり降ろさ	抑制単語	引き摺り下ろさ
ひきずりおろさ	引きずり降ろさ	抑制単語	引き摺り降ろさ
ひきずりおろし	ひきずり降ろし	抑制単語	引き摺り降ろし
ひきずりおろし	引きずりおろし	抑制単語	引き摺り下ろし
ひきずりおろし	引きずりおろし	抑制単語	引き摺り降ろし
ひきずりおろし	引きずり下ろし	抑制単語	引き摺り下ろし
ひきずりおろし	引きずり下ろし	抑制単語	引き摺り降ろし
ひきずりおろし	引きずり降ろし	抑制単語	引き摺り下ろし
ひきずりおろし	引きずり降ろし	抑制単語	引き摺り降ろし
ひきずりおろす	引きずり下ろす	抑制単語	引き摺り下ろす
ひきずりおろす	引きずり下ろす	抑制単語	引き摺り降ろす
ひきずりおろす	引きずり降ろす	抑制単語	引き摺り下ろす
ひきずりおろす	引きずり降ろす	抑制単語	引き摺り降ろす
ひきずりおろせ	引きずり下ろせ	抑制単語	引き摺り下ろせ
ひきずりおろせ	引きずり降ろせ	抑制単語	引き摺り下ろせ
ひきずりおろそ	引きずり下ろそ	抑制単語	引き摺り下ろそ
ひきずりおろそ	引きずり降ろそ	抑制単語	引き摺り下ろそ
ひきずりおろそう	引きずり下ろそう	抑制単語	引き摺り下ろそう
ひきずりおろそう	引きずり降ろそう	抑制単語	引き摺り下ろそう
ひきずりこま	引きずりこま	抑制単語	引き摺り込ま
ひきずりこま	引きずり込ま	抑制単語	引き摺り込ま
ひきずりこま	ひきずり込ま	抑制単語	引き摺り込ま
ひきずりこみ	引きずりこみ	抑制単語	引き摺り込み
ひきずりこみ	引きずり込み	抑制単語	引き摺り込み
ひきずりこむ	引きずりこむ	抑制単語	引き摺り込む
ひきずりこむ	引きずり込む	抑制単語	引き摺り込む
ひきずりこも	引きずりこも	抑制単語	引き摺り込も
ひきずりこも	引きずり込も	抑制単語	引き摺り込も
ひきずりこもう	引きずりこもう	抑制単語	引き摺り込もう
ひきずりこもう	引きずり込もう	抑制単語	引き摺り込もう
ひきずりこん	引きずりこん	抑制単語	引き摺り込ん
ひきずりこん	引きずり込ん	抑制単語	引き摺り込ん
ひきずりださ	引きずり出さ	抑制単語	引き摺り出さ
ひきずりださ	引きずりださ	抑制単語	引き摺り出さ
ひきずりだし	引きずり出し	抑制単語	引き摺り出し
ひきずりだし	引きずりだし	抑制単語	引き摺り出し
ひきずりだす	引きずり出す	抑制単語	引き摺り出す
ひきずりだす	引きずりだす	抑制単語	引き摺り出す
ひきずりまわさ	引きずり回さ	抑制単語	引き摺り回さ
ひきずりまわし	引きずりまわし	抑制単語	引き摺り回し
ひきずりまわし	引きずり回し	抑制単語	引き摺り回し
ひきずりまわす	引きずり回す	抑制単語	引き摺り回す
ひきずる	引きずる	抑制単語	引き摺る
ひきそろえ	引きそろえ	抑制単語	引き揃え
ひきそろえる	引きそろえる	抑制単語	引き揃える
ひきたた	ひき立た	抑制単語	惹き立た
ひきたち	ひき立ち	抑制単語	惹き立ち
ひきたっ	ひき立っ	抑制単語	惹き立っ
ひきたつ	ひき立つ	抑制単語	惹き立つ
ひきたて	ひき立て	抑制単語	惹き立て
ひきたて	ひき立て	抑制単語	挽き立て
ひきたてる	ひき立てる	抑制単語	惹き立てる
ひきださ	ひき出さ	抑制単語	惹き出さ
ひきださ	ひき出さ	抑制単語	挽き出さ
ひきださ	ひき出さ	抑制単語	曳き出さ
ひきつっ	引きつっ	抑制単語	引き攣っ
ひきつら	引きつら	抑制単語	引き攣ら
ひきつり	引きつり	抑制単語	引き攣り
ひきつる	引きつる	抑制単語	引き攣る
ひきにく	ひき肉	抑制単語	挽き肉
ひきにく	ひき肉	抑制単語	挽肉
ひきにげ	ひき逃げ	抑制単語	轢き逃げ
ひきはがさ	引きはがさ	抑制単語	引き剥がさ
ひきはがし	引きはがし	抑制単語	引き剥がし
ひきはがす	引きはがす	抑制単語	引き剥がす
ひきはがせ	引きはがせ	抑制単語	引き剥がせ
ひきはがせる	引きはがせる	抑制単語	引き剥がせる
ひきはがそ	引きはがそ	抑制単語	引き剥がそ
ひきはがそう	引きはがそう	抑制単語	引き剥がそう
ひきまわし	引きまわし	抑制単語	引き廻し
ひきょうもの	ひきょう者	抑制単語	卑怯者
ひきよせ	ひき寄せ	抑制単語	惹き寄せ
ひきわり	ひき割り	抑制単語	挽割り
ひけんいん	被けん引	抑制単語	被牽引
ひけんいんしゃ	被けん引車	抑制単語	被牽引車
ひげだつもう	ひげ脱毛	抑制単語	髭脱毛
ひこつ	ひ骨	抑制単語	腓骨
ひさびさ	久びさ	抑制単語	久々
ひざうら	ひざ裏	抑制単語	膝裏
ひざかけ	ひざ掛け	抑制単語	膝掛け
ひざかんせつ	ひざ関節	抑制単語	膝関節
ひざこぞう	ひざ小僧	抑制単語	膝小僧
ひざずめ	ひざ詰め	抑制単語	膝詰め
ひざたけ	ひざ丈	抑制単語	膝丈
ひざたけすかーと	ひざ丈スカート	抑制単語	膝丈スカート
ひざづめ	ひざ詰め	抑制単語	膝詰め
ひざもと	ひざ元	抑制単語	膝元
ひざをまじえ	ひざを交え	抑制単語	膝を交え
ひしがた	ひし形	抑制単語	菱形
ひしめきあう	ひしめき合う	抑制単語	犇めき合う
ひしめきあっ	ひしめき合っ	抑制単語	犇めき合っ
ひしょう	飛しょう	抑制単語	飛翔
ひじおき	ひじ置き	抑制単語	肘置き
ひじかけ	ひじ掛け	抑制単語	肘掛
ひじかけ	ひじ掛け	抑制単語	肘掛け
ひじてつ	ひじ鉄	抑制単語	肘鉄
ひそ	ひ素	抑制単語	砒素
ひぞう	ひ臓	抑制単語	脾臓
ひだまり	日だまり	抑制単語	日溜まり
ひだまり	日だまり	抑制単語	日溜り
ひだりひざ	左ひざ	抑制単語	左膝
ひだりひじ	左ひじ	抑制単語	左肘
ひだりわき	左わき	抑制単語	左脇
ひっかい	引っかい	抑制単語	引っ掻い
ひっかい	引っかい	抑制単語	引掻い
ひっかか	引っかか	抑制単語	引っ掻か
ひっかか	引っかか	抑制単語	引掻か
ひっかき	引っかき	抑制単語	引っ掻き
ひっかき	引っかき	抑制単語	引っ搔き
ひっかき	引っかき	抑制単語	引掻き
ひっかききず	ひっかき傷	抑制単語	引っ掻き傷
ひっかききず	ひっかき傷	抑制単語	引っ搔き傷
ひっかききず	ひっかき傷	抑制単語	引掻き傷
ひっかききず	引っかき傷	抑制単語	引っ掻き傷
ひっかききず	引っかき傷	抑制単語	引っ搔き傷
ひっかききず	引っかき傷	抑制単語	引掻き傷
ひっかきまわさ	引っかきまわさ	抑制単語	引っ掻きまわさ
ひっかきまわさ	ひっかき回さ	抑制単語	引っ掻き回さ
ひっかきまわさ	引っかき回さ	抑制単語	引っ掻き回さ
ひっかきまわし	引っかきまわし	抑制単語	引っ掻きまわし
ひっかきまわし	ひっかき回し	抑制単語	引っ掻き回し
ひっかきまわし	引っかき回し	抑制単語	引っ掻き回し
ひっかきまわす	引っかきまわす	抑制単語	引っ掻きまわす
ひっかきまわす	ひっかき回す	抑制単語	引っ掻き回す
ひっかきまわす	引っかき回す	抑制単語	引っ掻き回す
ひっかく	引っかく	抑制単語	引っ掻く
ひっかく	引っかく	抑制単語	引掻く
ひっかけ	引っかけ	抑制単語	引っ掻け
ひっかこう	引っかこう	抑制単語	引っ掻こう
ひっつかみ	引っつかみ	抑制単語	引っ掴み
ひっつかむ	引っつかむ	抑制単語	引っ掴む
ひっつかん	引っつかん	抑制単語	引っ掴ん
ひっぱく	ひっ迫	抑制単語	逼迫
ひっぱたい	引っぱたい	抑制単語	引っ叩い
ひっぱたか	引っぱたか	抑制単語	引っ叩か
ひっぱたき	引っぱたき	抑制単語	引っ叩き
ひっぱたく	引っぱたく	抑制単語	引っ叩く
ひとうらやましい	人うらやましい	抑制単語	人羨ましい
ひとかわむい	一皮むい	抑制単語	一皮剥い
ひとかわむき	一皮むき	抑制単語	一皮剥き
ひとかわむく	一皮むく	抑制単語	一皮剥く
ひとかわむけ	一皮むけ	抑制単語	一皮剥け
ひとかわむけ	一皮むけ	抑制単語	一皮剥け
ひとかわむけ	一皮むけ	抑制単語	一皮剥け
ひとかわむけ	ひと皮むけ	抑制単語	ひと皮剥け
ひとかわむけ	ひと皮むけ	抑制単語	一皮剥け
ひとかわむける	一皮むける	抑制単語	一皮剥ける
ひとかわむける	ひと皮むける	抑制単語	ひと皮剥ける
ひとかわむける	ひと皮むける	抑制単語	一皮剥ける
ひとかわむけれ	一皮むけれ	抑制単語	一皮剥けれ
ひとこま	一こま	抑制単語	一齣
ひとさらい	人さらい	抑制単語	人攫い
ひとすごい	人すごい	抑制単語	人凄い
ひとのふんどしですもうをとっ	人のふんどしで相撲をとっ	抑制単語	人の褌で相撲をとっ
ひとのふんどしですもうをとっ	人のふんどしで相撲をとっ	抑制単語	人の褌で相撲を取っ
ひとのふんどしですもうをとっ	人のふんどしで相撲を取っ	抑制単語	人の褌で相撲をとっ
ひとのふんどしですもうをとっ	人のふんどしで相撲を取っ	抑制単語	人の褌で相撲を取っ
ひとのふんどしですもうをとる	人のふんどしで相撲をとる	抑制単語	人の褌で相撲をとる
ひとのふんどしですもうをとる	人のふんどしで相撲をとる	抑制単語	人の褌で相撲を取る
ひとのふんどしですもうをとる	人のふんどしで相撲を取る	抑制単語	人の褌で相撲をとる
ひとのふんどしですもうをとる	人のふんどしで相撲を取る	抑制単語	人の褌で相撲を取る
ひとびと	人びと	抑制単語	人々
ひとめをはばかっ	人目をはばかっ	抑制単語	人目を憚っ
ひとめをはばから	人目をはばから	抑制単語	人目を憚ら
ひとめをはばかり	人目をはばかり	抑制単語	人目を憚り
ひとめをはばかる	人目をはばかる	抑制単語	人目を憚る
ひながた	ひな型	抑制単語	雛型
ひなだん	ひな壇	抑制単語	雛壇
ひなどり	ひな鳥	抑制単語	雛鳥
ひなにんぎょう	ひな人形	抑制単語	雛人形
ひなまつり	ひな祭り	抑制単語	雛祭
ひねりあげ	ひねり上げ	抑制単語	捻り上げ
ひねりあげる	ひねり上げる	抑制単語	捻り上げる
ひねりあわせ	ひねり合わせ	抑制単語	撚り合せ
ひねりいれ	ひねり入れ	抑制単語	捻り入れ
ひねりうち	ひねり打ち	抑制単語	捻り打ち
ひねりきい	ひねり効い	抑制単語	捻り効い
ひねりくわえ	ひねり加え	抑制単語	捻り加え
ひねりださ	ひねり出さ	抑制単語	捻り出さ
ひねりだし	ひねり出し	抑制単語	捻り出し
ひねりだす	ひねり出す	抑制単語	捻り出す
ひねりだせ	ひねり出せ	抑制単語	捻り出せ
ひねりだせ	ひねり出せ	抑制単語	捻り出せ
ひねりだせる	ひねり出せる	抑制単語	捻り出せる
ひねりだそ	ひねり出そ	抑制単語	捻り出そ
ひねりもどし	ひねり戻し	抑制単語	捻り戻し
ひのきざい	ひのき材	抑制単語	桧材
ひのきざい	ひのき材	抑制単語	檜材
ひのきぶたい	ひのき舞台	抑制単語	桧舞台
ひのきぶたい	ひのき舞台	抑制単語	檜舞台
ひのみやぐら	火の見やぐら	抑制単語	火の見櫓
ひばく	被ばく	抑制単語	被曝
ひばくしゃ	被ばく者	抑制単語	被曝者
ひばくせんりょう	被ばく線量	抑制単語	被曝線量
ひばくりょう	被ばく量	抑制単語	被曝量
ひびわれ	ひび割れ	抑制単語	罅割れ
ひふがん	皮膚がん	抑制単語	皮膚癌
ひぶた	火ぶた	抑制単語	火蓋
ひぶたをきっ	火ぶたを切っ	抑制単語	火蓋を切っ
ひぶたをきる	火ぶたを切る	抑制単語	火蓋を切る
ひまご	ひ孫	抑制単語	曾孫
ひましゆ	ひまし油	抑制単語	蓖麻子油
ひまつ	飛まつ	抑制単語	飛沫
ひまつぶし	暇つぶし	抑制単語	暇潰し
ひまつぶし	暇つぶし	抑制単語	暇潰し
ひまつぶしていど	暇つぶし程度	抑制単語	暇潰し程度
ひもずい	ひも付い	抑制単語	紐付い
ひもずき	ひも付き	抑制単語	紐付き
ひもずく	ひも付く	抑制単語	紐付く
ひもずけ	ひも付け	抑制単語	紐付け
ひもずけ	ひも付け	抑制単語	紐付け
ひもずける	ひも付ける	抑制単語	紐付ける
ひもづい	ひも付い	抑制単語	紐付い
ひもづき	ひも付き	抑制単語	紐付き
ひもづく	ひも付く	抑制単語	紐付く
ひもづけ	ひも付け	抑制単語	紐付け
ひもづけ	ひも付け	抑制単語	紐付け
ひもづける	ひも付ける	抑制単語	紐付ける
ひもとおし	ひも通し	抑制単語	紐通し
ひゃくにちぜき	百日ぜき	抑制単語	百日咳
ひょうへん	ひょう変	抑制単語	豹変
ひょうぼう	標ぼう	抑制単語	標榜
ひよく	肥よく	抑制単語	肥沃
ひらちゃわん	平茶わん	抑制単語	平茶碗
ひろびろ	広びろ	抑制単語	広々
ひろびろ	広びろ	抑制単語	広々
ひわい	卑わい	抑制単語	卑猥
ひをおこし	火をおこし	抑制単語	火を熾し
ひをおこし	火を起こし	抑制単語	火を熾し
ひをおこす	火をおこす	抑制単語	火を熾す
ひをおこす	火を起こす	抑制単語	火を熾す
ひんし	ひん死	抑制単語	瀕死
ひんしゅくをかい	ひんしゅくを買い	抑制単語	顰蹙を買い
ひんしゅくをかう	ひんしゅくを買う	抑制単語	顰蹙を買う
ひんしゅくをかっ	ひんしゅくを買っ	抑制単語	顰蹙を買っ
ひんしゅくをかわ	ひんしゅくを買わ	抑制単語	顰蹙を買わ
びにいりさいをうがっ	微に入り細をうがっ	抑制単語	微に入り細を穿っ
びにいりさいをうがつ	微に入り細をうがつ	抑制単語	微に入り細を穿つ
びぼう	美ぼう	抑制単語	美貌
びまん	び漫	抑制単語	瀰漫
びょうが	病が	抑制単語	病臥
びんしょう	敏しょう	抑制単語	敏捷
びんしょう	敏しょう	抑制単語	敏捷
びんせん	便せん	抑制単語	便箋
びんぼうくじ	貧乏くじ	抑制単語	貧乏籤
びんらん	びん乱	抑制単語	紊乱
びーずししゅう	ビーズ刺しゅう	抑制単語	ビーズ刺繍
ふうかん	封かん	抑制単語	封緘
ふうしん	風しん	抑制単語	風疹
ふうび	風び	抑制単語	風靡
ふうぼう	風ぼう	抑制単語	風貌
ふか	ふ化	抑制単語	孵化
ふかいつながり	深いつながり	抑制単語	深い繋がり
ふきあげ	ふき上げ	抑制単語	拭き上げ
ふきうるし	ふき漆	抑制単語	拭き漆
ふきさらさ	吹きさらさ	抑制単語	吹き晒さ
ふきさらさ	吹きさらさ	抑制単語	吹き曝さ
ふきさらし	吹きさらし	抑制単語	吹き曝し
ふきさらし	吹きさらし	抑制単語	吹曝し
ふきだまっ	吹きだまっ	抑制単語	吹き溜まっ
ふきだまり	吹きだまり	抑制単語	吹き溜まり
ふきだまり	吹きだまり	抑制単語	吹き溜り
ふきだまり	吹きだまり	抑制単語	吹溜り
ふきだまる	吹きだまる	抑制単語	吹き溜まる
ふきと	ふき取	抑制単語	拭き取
ふきとっ	ふき取っ	抑制単語	拭き取っ
ふきとら	ふき取ら	抑制単語	拭き取ら
ふきとり	ふき取り	抑制単語	拭き取り
ふきとりかわかし	ふき取り乾かし	抑制単語	拭き取り乾かし
ふきとりし	ふき取りし	抑制単語	拭き取りし
ふきとりする	ふき取りする	抑制単語	拭き取りする
ふきとりにくい	ふき取りにくい	抑制単語	拭き取りにくい
ふきとりやすい	ふき取りやすい	抑制単語	拭き取りやすい
ふきとりやすく	ふき取りやすく	抑制単語	拭き取りやすく
ふきとりよう	ふき取りよう	抑制単語	拭き取りよう
ふきとる	ふき取る	抑制単語	拭き取る
ふきとれ	ふき取れ	抑制単語	拭き取れ
ふきとれ	ふき取れ	抑制単語	拭き取れ
ふきとろ	ふき取ろ	抑制単語	拭き取ろ
ふきぬけ	ふき抜け	抑制単語	拭き抜け
ふきのこし	ふき残し	抑制単語	拭き残し
ふくしゃ	ふく射	抑制単語	輻射
ふくしゃねつ	ふく射熱	抑制単語	輻射熱
ふくしゅう	復しゅう	抑制単語	復讎
ふくしゅう	復しゅう	抑制単語	復讐
ふくじん	副じん	抑制単語	副腎
ふくじんたい	副じん帯	抑制単語	副靭帯
ふくじんたい	副じん帯	抑制単語	副靱帯
ふくろとじ	袋とじ	抑制単語	袋綴
ふけあがり	ふけ上がり	抑制単語	拭け上がり
ふけあがる	ふけ上がる	抑制単語	拭け上がる
ふさぎいた	ふさぎ板	抑制単語	塞ぎ板
ふさぎこま	ふさぎ込ま	抑制単語	塞ぎ込ま
ふさぎこみ	ふさぎ込み	抑制単語	塞ぎ込み
ふさぎこみがち	ふさぎ込みがち	抑制単語	塞ぎ込みがち
ふさぎこむ	ふさぎ込む	抑制単語	塞ぎ込む
ふさぎこん	ふさぎ込ん	抑制単語	塞ぎ込ん
ふしまわし	節まわし	抑制単語	節廻し
ふせん	付せん	抑制単語	付箋
ふぞろい	不ぞろい	抑制単語	不揃い
ふぞろい	不ぞろい	抑制単語	不揃い
ふたつき	フタ付き	抑制単語	蓋付
ふっしょく	払しょく	抑制単語	払拭
ふっそ	ふっ素	抑制単語	弗素
ふってわい	降ってわい	抑制単語	降って湧い
ふとう	ふ頭	抑制単語	埠頭
ふともも	太もも	抑制単語	太股
ふともも	太もも	抑制単語	太腿
ふねをこい	舟をこい	抑制単語	舟を漕い
ふねをこい	船をこい	抑制単語	船を漕い
ふねをこぎ	舟をこぎ	抑制単語	舟を漕ぎ
ふねをこぎ	船をこぎ	抑制単語	船を漕ぎ
ふねをこぐ	舟をこぐ	抑制単語	舟を漕ぐ
ふねをこぐ	船をこぐ	抑制単語	船を漕ぐ
ふびん	不びん	抑制単語	不憫
ふみつぶさ	踏みつぶさ	抑制単語	踏み潰さ
ふみつぶし	踏みつぶし	抑制単語	踏み潰し
ふみつぶす	踏みつぶす	抑制単語	踏み潰す
ふみつぶせ	踏みつぶせ	抑制単語	踏み潰せ
ふみつぶせ	踏みつぶせ	抑制単語	踏み潰せ
ふみつぶせる	踏みつぶせる	抑制単語	踏み潰せる
ふみつぶそ	踏みつぶそ	抑制単語	踏み潰そ
ふみつぶそう	踏みつぶそう	抑制単語	踏み潰そう
ふみにじ	踏みにじ	抑制単語	踏み躙
ふみにじっ	踏みにじっ	抑制単語	踏み躙っ
ふみにじら	踏みにじら	抑制単語	踏み躙ら
ふみにじり	踏みにじり	抑制単語	踏み躙り
ふみにじる	踏みにじる	抑制単語	踏み躙る
ふめいりょう	不明りょう	抑制単語	不明瞭
ふゆごろ	冬ごろ	抑制単語	冬頃
ふらん	ふ卵	抑制単語	孵卵
ふらん	腐らん	抑制単語	腐爛
ふりかざし	振りかざし	抑制単語	振り翳し
ふりかざす	振りかざす	抑制単語	振り翳す
ふりそで	振りそで	抑制単語	振り袖
ふりそで	振りそで	抑制単語	振袖
ふりまい	振りまい	抑制単語	振り撒い
ふりまか	振りまか	抑制単語	振り撒か
ふりまき	振りまき	抑制単語	振り撒き
ふりまく	振りまく	抑制単語	振り撒く
ふりまわさ	振りまわさ	抑制単語	振り廻さ
ふりまわし	振りまわし	抑制単語	振り廻し
ふりまわす	振りまわす	抑制単語	振り廻す
ふるいいれ	ふるい入れ	抑制単語	篩い入れ
ふるいいれ	振るい入れ	抑制単語	篩い入れ
ふるいおとさ	ふるい落とさ	抑制単語	篩い落とさ
ふるいおとし	ふるい落し	抑制単語	篩い落とし
ふるいおとし	ふるい落とし	抑制単語	篩い落とし
ふるいおとす	ふるい落とす	抑制単語	篩い落とす
ふるいにかけ	ふるいに掛け	抑制単語	篩いに掛け
ふるいにかけ	ふるいに掛け	抑制単語	篩いに掛け
ふるいにかけ	ふるいに掛け	抑制単語	篩に掛け
ふるいわけ	ふるい分け	抑制単語	篩い分け
ふるいわけし	ふるい分けし	抑制単語	篩い分けし
ふるいわける	ふるい分ける	抑制単語	篩い分ける
ふろふき	ふろ吹き	抑制単語	風呂吹き
ふんぎり	踏ん切り	抑制単語	糞切り
ふんじん	粉じん	抑制単語	粉塵
ふんそう	ふん装	抑制単語	扮装
ふんべん	ふん便	抑制単語	糞便
ふんまん	憤まん	抑制単語	憤懣
ぶざつ	ぶ雑	抑制単語	蕪雑
ぶしょうひげ	不精ひげ	抑制単語	不精髭
ぶしょうひげ	不精ひげ	抑制単語	無精髭
ぶぜん	ぶ然	抑制単語	憮然
ぶたいあいさつ	舞台あいさつ	抑制単語	舞台挨拶
ぶたしょうがやき	豚しょうが焼き	抑制単語	豚生姜焼き
ぶたひきにく	豚ひき肉	抑制単語	豚挽き肉
ぶたひきにく	豚ひき肉	抑制単語	豚挽肉
ぶどういろ	ぶどう色	抑制単語	葡萄色
ぶどうえん	ぶどう園	抑制単語	葡萄園
ぶどうさいばい	ぶどう栽培	抑制単語	葡萄栽培
ぶどうとう	ぶどう糖	抑制単語	葡萄糖
ぶどうばたけ	ぶどう畑	抑制単語	葡萄畑
ぶどうひんしゅ	ぶどう品種	抑制単語	葡萄品種
ぶぶんやせ	部分やせ	抑制単語	部分痩せ
ぶんけつ	分けつ	抑制単語	分蘖
ぶんべん	分べん	抑制単語	分娩
へいし	へい死	抑制単語	斃死
へいそく	閉そく	抑制単語	閉塞
へいたん	兵たん	抑制単語	兵站
へいたん	平たん	抑制単語	平坦
へきち	へき地	抑制単語	僻地
へそのお	へその緒	抑制単語	臍の緒
へそをまげ	へそを曲げ	抑制単語	臍を曲げ
へたくそ	下手くそ	抑制単語	下手糞
へっぴりごし	へっぴり腰	抑制単語	屁っ放り腰
へのかっぱ	への河童	抑制単語	屁の河童
へらずぐちをたたく	減らず口をたたく	抑制単語	減らず口を叩く
へんさん	編さん	抑制単語	編纂
へんぴ	辺ぴ	抑制単語	辺鄙
へんぺい	へん平	抑制単語	扁平
へんぺいそく	へん平足	抑制単語	扁平足
へんぼう	変ぼう	抑制単語	変貌
へんりん	片りん	抑制単語	片鱗
べっこう	べっ甲	抑制単語	鼈甲
べっし	べっ視	抑制単語	蔑視
べつだんすごい	別段すごい	抑制単語	別段凄い
べにざけ	紅ざけ	抑制単語	紅鮭
べにしょうが	紅しょうが	抑制単語	紅生姜
べらぼう	べら棒	抑制単語	篦棒
べんそ	弁そ	抑制単語	弁疏
ほうが	ほう芽	抑制単語	萌芽
ほうき	ほう起	抑制単語	蜂起
ほうきぼし	ほうき星	抑制単語	帚星
ほうきぼし	ほうき星	抑制単語	箒星
ほうさい	報さい	抑制単語	報賽
ほうさん	ほう酸	抑制単語	硼酸
ほうし	奉し	抑制単語	奉祀
ほうしゃせんひばく	放射線被ばく	抑制単語	放射線被曝
ほうじちゃ	ほうじ茶	抑制単語	焙じ茶
ほうじょ	ほう助	抑制単語	幇助
ほうせんか	ほうせん花	抑制単語	鳳仙花
ほうてん	奉てん	抑制単語	奉奠
ほうとう	放とう	抑制単語	放蕩
ほうりだし	ほうり出し	抑制単語	抛り出し
ほうれんそう	ほうれん草	抑制単語	法蓮草
ほうれんそう	ほうれん草	抑制単語	菠薐草
ほえたける	ほえ猛る	抑制単語	吠え猛る
ほおばっ	ほお張っ	抑制単語	頬張っ
ほおばり	ほお張り	抑制単語	頬張り
ほおばる	ほお張る	抑制単語	頬張る
ほおばれ	ほお張れ	抑制単語	頬張れ
ほおべに	ほお紅	抑制単語	頬紅
ほおぼね	ほお骨	抑制単語	頬骨
ほおぼね	ほお骨	抑制単語	頰骨
ほしあわび	干しあわび	抑制単語	干し鮑
ほしあんず	干しあんず	抑制単語	干し杏
ほしえび	干しえび	抑制単語	干し蝦
ほしくず	星くず	抑制単語	星屑
ほししいたけ	干ししいたけ	抑制単語	干し椎茸
ほしたけのこ	干したけのこ	抑制単語	干し筍
ほしのり	干しのり	抑制単語	干し海苔
ほしぶどう	干しぶどう	抑制単語	干し葡萄
ほじくりかえさ	ほじくり返さ	抑制単語	穿り返さ
ほじくりかえし	ほじくり返し	抑制単語	穿り返し
ほじくりかえす	ほじくり返す	抑制単語	穿り返す
ほじくりだし	ほじくり出し	抑制単語	穿り出し
ほじくりだす	ほじくり出す	抑制単語	穿り出す
ほじりだし	ほじり出し	抑制単語	穿り出し
ほじりだす	ほじり出す	抑制単語	穿り出す
ほそく	捕そく	抑制単語	捕捉
ほてい	補てい	抑制単語	補綴
ほてん	補てん	抑制単語	補塡
ほてん	補てん	抑制単語	補填
ほとばしりで	ほとばしり出	抑制単語	迸り出
ほとばしりでる	ほとばしり出る	抑制単語	迸り出る
ほとんどいま	ほとんど今	抑制単語	殆ど今
ほとんどじかん	ほとんど時間	抑制単語	殆ど時間
ほとんどじぶん	ほとんど自分	抑制単語	殆ど自分
ほとんどすべて	ほとんど全て	抑制単語	殆ど全て
ほとんどすべて	ほとんど全て	抑制単語	殆んど全て
ほとんどぜんいん	ほとんど全員	抑制単語	殆ど全員
ほとんどぜんぶ	ほとんど全部	抑制単語	殆ど全部
ほとんどまいかい	ほとんど毎回	抑制単語	殆ど毎回
ほとんどまいしゅう	ほとんど毎週	抑制単語	殆ど毎週
ほとんどまいにち	ほとんど毎日	抑制単語	殆ど毎日
ほとんどまえ	ほとんど前	抑制単語	殆ど前
ほどすごい	程すごい	抑制単語	程凄い
ほにゅう	ほ乳	抑制単語	哺乳
ほにゅうびん	ほ乳瓶	抑制単語	哺乳ビン
ほにゅうびん	ほ乳瓶	抑制単語	哺乳瓶
ほにゅうるい	ほ乳類	抑制単語	哺乳類
ほねみにしみ	骨身にしみ	抑制単語	骨身に沁み
ほねみにしみる	骨身にしみる	抑制単語	骨身に沁みる
ほのあかるい	ほの明るい	抑制単語	仄明るい
ほのぐらい	ほの暗い	抑制単語	仄暗い
ほのぐらき	ほの暗き	抑制単語	仄暗き
ほのぐらく	ほの暗く	抑制単語	仄暗く
ほのぐらさ	ほの暗さ	抑制単語	仄暗さ
ほふくせい	ほふく性	抑制単語	匍匐性
ほふくぜんしん	ほふく前進	抑制単語	匍匐前進
ほめたたえ	褒めたたえ	抑制単語	褒め讃え
ほめたたえ	誉めたたえ	抑制単語	誉め讃え
ほらをふい	ほらを吹い	抑制単語	法螺を吹い
ほらをふき	ほらを吹き	抑制単語	法螺を吹き
ほらをふく	ほらを吹く	抑制単語	法螺を吹く
ほりくぼめ	彫りくぼめ	抑制単語	彫り窪め
ほりくぼめ	掘りくぼめ	抑制単語	掘り窪め
ほりごたつ	掘りごたつ	抑制単語	掘り炬燵
ほりごたつこしつ	掘りごたつ個室	抑制単語	掘り炬燵個室
ほりごたつしき	掘りごたつ式	抑制単語	掘り炬燵式
ほりごたつせき	掘りごたつ席	抑制単語	掘り炬燵席
ほれこみ	ほれ込み	抑制単語	惚れ込み
ほれこむ	ほれ込む	抑制単語	惚れ込む
ほれこん	ほれ込ん	抑制単語	惚れ込ん
ほれなおし	ほれ直し	抑制単語	惚れ直し
ほれなおす	ほれ直す	抑制単語	惚れ直す
ほんかまど	本かまど	抑制単語	本竈
ほんかや	本かや	抑制単語	本榧
ほんすごい	本すごい	抑制単語	本凄い
ほんすごく	本すごく	抑制単語	本凄く
ほんずわいがに	本ずわいがに	抑制単語	本ずわい蟹
ほんずわいがに	本ずわいがに	抑制単語	本ズワイ蟹
ほんつげ	本つげ	抑制単語	本柘植
ほんつげ	本つげ	抑制単語	本黄楊
ほんとうすごい	本当すごい	抑制単語	本当凄い
ほんべっこう	本べっ甲	抑制単語	本鼈甲
ほんまぐろ	本まぐろ	抑制単語	本鮪
ほんみりん	本みりん	抑制単語	本味醂
ほんろう	翻ろう	抑制単語	翻弄
ほんわさび	本わさび	抑制単語	本山葵
ぼうぎょ	防ぎょ	抑制単語	防禦
ぼうくうごう	防空ごう	抑制単語	防空壕
ぼうさいずきん	防災ずきん	抑制単語	防災頭巾
ぼうとく	冒とく	抑制単語	冒涜
ぼうとく	冒とく	抑制単語	冒瀆
ぼくとつ	木とつ	抑制単語	木訥
ぼくとつ	朴とつ	抑制単語	朴訥
ぼくとつ	朴とつ	抑制単語	朴訥
ぼたんゆき	ぼたん雪	抑制単語	牡丹雪
ぼだいじゅ	ぼだい樹	抑制単語	菩提樹
ぼっぱつ	ぼっ発	抑制単語	勃発
ぽんずしょうゆ	ポン酢しょうゆ	抑制単語	ポン酢醤油
まいか	真いか	抑制単語	真烏賊
まいかいうれしい	毎回うれしい	抑制単語	毎回嬉しい
まいかいすごい	毎回すごい	抑制単語	毎回凄い
まいかいすごく	毎回すごく	抑制単語	毎回凄く
まいしん	まい進	抑制単語	邁進
まいとしすごい	毎年すごい	抑制単語	毎年凄い
まいとしすごく	毎年すごく	抑制単語	毎年凄く
まいどすごい	毎度すごい	抑制単語	毎度凄い
まいにちうっとうしい	毎日うっとうしい	抑制単語	毎日鬱陶しい
まいにちうれしい	毎日うれしい	抑制単語	毎日嬉しい
まいにちすごい	毎日すごい	抑制単語	毎日凄い
まいにちすごく	毎日すごく	抑制単語	毎日凄く
まいにちものすごい	毎日ものすごい	抑制単語	毎日物凄い
まえごろ	前ごろ	抑制単語	前頃
まえすごい	前すごい	抑制単語	前凄い
まえすごく	前すごく	抑制単語	前凄く
まきあげ	まき上げ	抑制単語	撒き上げ
まきえ	まき絵	抑制単語	蒔絵
まきおこし	まき起こし	抑制単語	捲き起こし
まきおこし	まき起こし	抑制単語	捲き起し
まきおこす	まき起こす	抑制単語	捲き起こす
まきおこる	まき起こる	抑制単語	捲き起こる
まきす	巻きす	抑制単語	巻き簾
まきずし	巻き寿司	抑制単語	巻鮨
まきずし	巻きずし	抑制単語	巻鮨
まきそだて	まき育て	抑制単語	蒔き育て
まきため	巻きため	抑制単語	巻き溜め
まきちらかさ	まき散らかさ	抑制単語	撒き散らかさ
まきちらかし	まき散らかし	抑制単語	撒き散らかし
まきちらかす	まき散らかす	抑制単語	撒き散らかす
まきちらさ	まき散らさ	抑制単語	撒き散らさ
まきちらし	まき散らし	抑制単語	撒き散らし
まきちらし	まき散らし	抑制単語	蒔き散らし
まきちらす	まき散らす	抑制単語	撒き散らす
まきちらせ	まき散らせ	抑制単語	撒き散らせ
まきちらそ	まき散らそ	抑制単語	撒き散らそ
まきつけ	まき付け	抑制単語	蒔き付け
まきもどっ	まき戻っ	抑制単語	撒き戻っ
まくしたて	まくし立て	抑制単語	捲し立て
まくしたて	まくし立て	抑制単語	捲し立て
まくしたてる	まくし立てる	抑制単語	捲し立てる
まくらぎ	まくら木	抑制単語	枕木
まくらもと	まくら元	抑制単語	枕元
まくりあげ	まくり上げ	抑制単語	捲り上げ
まくりあげる	まくり上げる	抑制単語	捲り上げる
まくりさし	まくり差し	抑制単語	捲り差し
まけにつながる	負けにつながる	抑制単語	負けに繋がる
まげもの	曲げ物	抑制単語	髷物
まさば	真さば	抑制単語	真鯖
ましん	麻しん	抑制単語	麻疹
ますせき	ます席	抑制単語	枡席
ますめ	ます目	抑制単語	枡目
ますめ	ます目	抑制単語	桝目
またぎこし	またぎ越し	抑制単語	跨ぎ越し
またした	また下	抑制単語	股下
またら	真たら	抑制単語	真鱈
まだこ	真だこ	抑制単語	真蛸
まだなじみがうすい	まだなじみが薄い	抑制単語	まだ馴染みが薄い
まだまだなじみがうすい	まだまだなじみが薄い	抑制単語	まだまだ馴染みが薄い
まちくたびれ	待ちくたびれ	抑制単語	待ち草臥れ
まちわび	待ちわび	抑制単語	待ち侘び
まちわびる	待ちわびる	抑制単語	待ち侘びる
まっきがん	末期がん	抑制単語	末期癌
まっくらやみ	真っ暗やみ	抑制単語	まっ暗闇
まっくらやみ	真っ暗やみ	抑制単語	真っ暗闇
まっしょう	末しょう	抑制単語	末梢
まったくうらやましい	全くうらやましい	抑制単語	全く羨ましい
まったくうらやましく	全くうらやましく	抑制単語	全く羨ましく
まったくうれしく	全くうれしく	抑制単語	全く嬉しく
まったくかゆく	全くかゆく	抑制単語	全く痒く
まったくすごい	全くすごい	抑制単語	全く凄い
まったくすごく	全くすごく	抑制単語	全く凄く
まったくばかばかしい	全くばかばかしい	抑制単語	全く馬鹿馬鹿しい
まっただなか	まっただ中	抑制単語	まっ只中
まっただなか	まっただ中	抑制単語	真っ只中
まっただなか	真っただ中	抑制単語	まっ只中
まっただなか	真っただ中	抑制単語	真っ只中
まっただなか	まっただ中	抑制単語	真只中
まっただなか	真っ直中	抑制単語	真只中
まつえい	末えい	抑制単語	末裔
まつかさ	松かさ	抑制単語	松毬
まつたけ	松たけ	抑制単語	松茸
まつばずえ	松葉づえ	抑制単語	松葉杖
まつばづえ	松葉づえ	抑制単語	松葉杖
まつぼっくり	松ぼっくり	抑制単語	松毬
まつりばやし	祭りばやし	抑制単語	祭り囃子
まとまりよく	まとまり良く	抑制単語	纏まり良く
まとめあげ	まとめ上げ	抑制単語	纏め上げ
まとめあげ	まとめ上げ	抑制単語	纏め上げ
まとめあげる	まとめ上げる	抑制単語	纏め上げる
まとめうり	まとめ売り	抑制単語	纏め売り
まとわりつい	まとわり付い	抑制単語	纏わり付い
まとわりつか	まとわり付か	抑制単語	纏わり付か
まとわりつき	まとわり付き	抑制単語	纏わり付き
まとわりつく	まとわり付く	抑制単語	纏わり付く
まどふき	窓ふき	抑制単語	窓拭き
まないた	まな板	抑制単語	俎板
まねきいただき	招きいただき	抑制単語	招き戴き
まばゆいひかり	まばゆい光	抑制単語	眩い光
まひ	麻ひ	抑制単語	麻痺
まぶしいひかり	まぶしい光	抑制単語	眩しい光
まめしば	豆しば	抑制単語	豆柴
まめまき	豆まき	抑制単語	豆撒き
まゆげ	まゆ毛	抑制単語	眉毛
まるつぶれ	丸つぶれ	抑制単語	丸潰れ
まるのみ	丸のみ	抑制単語	丸呑み
まるまげ	丸まげ	抑制単語	丸髷
まるまる	まる丸	抑制単語	丸々
まわしかけ	まわし掛け	抑制単語	廻し掛け
まわしのみ	まわし飲み	抑制単語	廻し飲み
まわしのみ	回しのみ	抑制単語	回し呑み
まわしよみ	まわし読み	抑制単語	廻し読み
まわれみぎ	まわれ右	抑制単語	廻れ右
まんえん	まん延	抑制単語	蔓延
まんじゅうや	まんじゅう屋	抑制単語	饅頭屋
まーぼーなす	麻婆なす	抑制単語	麻婆茄子
みかけにだまさ	見かけにだまさ	抑制単語	見かけに騙さ
みがい	見がい	抑制単語	見甲斐
みがきがい	磨きがい	抑制単語	磨き甲斐
みがきにしん	身欠きにしん	抑制単語	身欠き鰊
みがきにしん	身欠きにしん	抑制単語	身欠鰊
みぎひざ	右ひざ	抑制単語	右膝
みぎひじ	右ひじ	抑制単語	右肘
みぎわき	右わき	抑制単語	右脇
みくびっ	見くびっ	抑制単語	見縊っ
みくびら	見くびら	抑制単語	見縊ら
みくびる	見くびる	抑制単語	見縊る
みこしをかつい	みこしを担い	抑制単語	御輿を担い
みこしをかつぎ	みこしを担ぎ	抑制単語	御輿を担ぎ
みこしをかつぐ	みこしを担ぐ	抑制単語	御輿を担ぐ
みごもっ	身ごもっ	抑制単語	身篭っ
みごもっ	身ごもっ	抑制単語	身籠っ
みごもら	身ごもら	抑制単語	身篭ら
みごもら	身ごもら	抑制単語	身籠ら
みごもり	身ごもり	抑制単語	身篭り
みごもり	身ごもり	抑制単語	身籠り
みごもる	身ごもる	抑制単語	身篭る
みごもる	身ごもる	抑制単語	身籠る
みごろ	身ごろ	抑制単語	身頃
みすぼらしい	見すぼらしい	抑制単語	見窄らしい
みすぼらしく	見すぼらしく	抑制単語	見窄らしく
みずあか	水あか	抑制単語	水垢
みずあめ	水あめ	抑制単語	水飴
みずかき	水かき	抑制単語	水掻き
みずかさ	水かさ	抑制単語	水嵩
みずがめ	水がめ	抑制単語	水甕
みずごけ	水ごけ	抑制単語	水苔
みずごけ	水ごけ	抑制単語	水蘚
みずしぶき	水しぶき	抑制単語	水飛沫
みずたまり	水たまり	抑制単語	水溜まり
みずたまり	水たまり	抑制単語	水溜り
みずっぱな	水っぱな	抑制単語	水っ洟
みずなす	水なす	抑制単語	水茄子
みずぬれ	水ぬれ	抑制単語	水濡れ
みずのみびゃくしょう	水飲み百姓	抑制単語	水呑百姓
みずはけ	水はけ	抑制単語	水捌け
みずばな	水ばな	抑制単語	水洟
みずぶろ	水ぶろ	抑制単語	水風呂
みずほ	みず穂	抑制単語	瑞穂
みずぼうそう	水ぼうそう	抑制単語	水疱瘡
みずまくら	水まくら	抑制単語	水枕
みずまわり	水まわり	抑制単語	水廻り
みずまわり	水まわり	抑制単語	水廻り
みずまわりりふぉーむ	水まわりリフォーム	抑制単語	水廻りリフォーム
みずもち	水持ち	抑制単語	水餅
みずようかん	水ようかん	抑制単語	水羊羹
みそしる	みそ汁	抑制単語	味噌汁
みそっぱ	みそっ歯	抑制単語	味噌っ歯
みそづけ	みそ漬け	抑制単語	味噌漬け
みそづけ	みそ漬け	抑制単語	味噌漬
みそづけ	みそ漬け	抑制単語	味噌漬け
みそにこみ	みそ煮込み	抑制単語	味噌煮込み
みそやき	みそ焼き	抑制単語	味噌焼き
みだしなみ	身だしなみ	抑制単語	身嗜み
みちあふれ	満ちあふれ	抑制単語	満ち溢れ
みちあふれ	満ちあふれ	抑制単語	満ち溢れ
みちあふれる	満ちあふれる	抑制単語	満ち溢れる
みつどもえ	三つどもえ	抑制単語	三つ巴
みつどもえ	三つどもえ	抑制単語	三巴
みつまた	三つ又	抑制単語	三叉
みつまた	三つ又	抑制単語	三椏
みつまめ	みつ豆	抑制単語	蜜豆
みとがめ	見とがめ	抑制単語	見咎め
みとがめ	見とがめ	抑制単語	見咎め
みとがめる	見とがめる	抑制単語	見咎める
みとれ	見とれ	抑制単語	見惚れ
みとれ	見とれ	抑制単語	見惚れ
みとれ	見とれ	抑制単語	見蕩れ
みとれる	見とれる	抑制単語	見惚れる
みとれる	見とれる	抑制単語	見蕩れる
みなさ	見なさ	抑制単語	見做さ
みなさんすご	皆さんすご	抑制単語	皆さん凄
みなさんすごい	皆さんすごい	抑制単語	皆さん凄い
みなさんすごく	皆さんすごく	抑制単語	皆さん凄く
みなし	見なし	抑制単語	見做し
みなす	見なす	抑制単語	見做す
みなせ	見なせ	抑制単語	見做せ
みなれ	見なれ	抑制単語	見馴れ
みなれ	見なれ	抑制単語	見馴れ
みにしみ	身にしみ	抑制単語	身に沁み
みにしみ	身にしみ	抑制単語	身に沁み
みにしみる	身にしみる	抑制単語	身に沁みる
みにまとい	見にまとい	抑制単語	見に纏い
みにまとい	身にまとい	抑制単語	身に纏い
みにまとう	見にまとう	抑制単語	見に纏う
みにまとう	身にまとう	抑制単語	身に纏う
みにまとえ	身にまとえ	抑制単語	身に纏え
みにまとえ	身にまとえ	抑制単語	身に纏え
みにまとおう	身にまとおう	抑制単語	身に纏おう
みにまとっ	見にまとっ	抑制単語	見に纏っ
みにまとっ	身にまとっ	抑制単語	身に纏っ
みにまとわ	身にまとわ	抑制単語	身に纏わ
みほれ	見ほれ	抑制単語	見惚れ
みほれる	見ほれる	抑制単語	見惚れる
みみあか	耳あか	抑制単語	耳垢
みみかき	耳かき	抑制単語	耳掻き
みみざとい	耳ざとい	抑制単語	耳聡い
みみざとく	耳ざとく	抑制単語	耳聡く
みみたぶ	耳たぶ	抑制単語	耳朶
みみをそばだて	耳をそばだて	抑制単語	耳を欹て
みみをふさい	耳をふさい	抑制単語	耳を塞い
みみをふさが	耳をふさが	抑制単語	耳を塞が
みみをふさぎ	耳をふさぎ	抑制単語	耳を塞ぎ
みみをふさぐ	耳をふさぐ	抑制単語	耳を塞ぐ
みもだえ	身もだえ	抑制単語	身悶え
みもだえ	身もだえ	抑制単語	身悶え
みもだえる	身もだえる	抑制単語	身悶える
みやこまんじゅう	都まんじゅう	抑制単語	都饅頭
みをやつし	身をやつし	抑制単語	身を窶し
みをやつす	身をやつす	抑制単語	身を窶す
むかしすごい	昔すごい	抑制単語	昔凄い
むかしすごかっ	昔すごかっ	抑制単語	昔凄かっ
むかしすごく	昔すごく	抑制単語	昔凄く
むかしなじみ	昔なじみ	抑制単語	昔馴染
むきせ	むき背	抑制単語	剥き背
むきたて	むき縦	抑制単語	剥き縦
むきたべ	むき食べ	抑制単語	剥き食べ
むきださ	むき出さ	抑制単語	剥き出さ
むきだし	むき出し	抑制単語	剝き出し
むきだし	むき出し	抑制単語	剥き出し
むきだし	むき出し	抑制単語	剥き出し
むきだす	むき出す	抑制単語	剥き出す
むきで	むき出	抑制単語	剥き出
むきみ	むき身	抑制単語	剝き身
むきみ	むき身	抑制単語	剥き身
むぎみそ	麦みそ	抑制単語	麦味噌
むぎわら	麦わら	抑制単語	麦藁
むぎわらぼうし	麦わら帽子	抑制単語	麦藁帽子
むくのき	むくの木	抑制単語	椋の木
むくのき	むくの木	抑制単語	椋木
むさぼりくい	むさぼり食い	抑制単語	貪り食い
むさぼりくう	むさぼり食う	抑制単語	貪り食う
むさぼりくっ	むさぼり食っ	抑制単語	貪り食っ
むさぼりくらう	むさぼり食らう	抑制単語	貪り食らう
むさぼりくわ	むさぼり食わ	抑制単語	貪り食わ
むさぼりたべ	むさぼり食べ	抑制単語	貪り食べ
むさぼりたべる	むさぼり食べる	抑制単語	貪り食べる
むさぼりとる	むさぼり取る	抑制単語	貪り取る
むさぼりよみ	むさぼり読み	抑制単語	貪り読み
むさぼりよむ	むさぼり読む	抑制単語	貪り読む
むさぼりよん	むさぼり読ん	抑制単語	貪り読ん
むしかご	虫かご	抑制単語	虫籠
むしけら	虫けら	抑制単語	虫螻
むしず	虫ず	抑制単語	虫唾
むしずし	蒸しずし	抑制単語	蒸し鮨
むしなべ	蒸しなべ	抑制単語	蒸し鍋
むしなべ	蒸しなべ	抑制単語	蒸鍋
むしば	むし歯	抑制単語	齲歯
むしぶろ	蒸しぶろ	抑制単語	蒸し風呂
むしぶろ	蒸しぶろ	抑制単語	蒸風呂
むしゆで	蒸しゆで	抑制単語	蒸し茹で
むしりとっ	むしり取っ	抑制単語	毟り取っ
むしりとら	むしり取ら	抑制単語	毟り取ら
むしりとり	むしり取り	抑制単語	毟り取り
むしりとる	むしり取る	抑制単語	毟り取る
むしりとれ	むしり取れ	抑制単語	毟り取れ
むしりとれる	むしり取れる	抑制単語	毟り取れる
むしりとろ	むしり取ろ	抑制単語	毟り取ろ
むせかえる	むせ返る	抑制単語	咽返る
むせかえる	むせ返る	抑制単語	噎せ返る
むせびない	むせび泣い	抑制単語	咽び泣い
むせびなき	むせび泣き	抑制単語	咽び泣き
むせびなく	むせび泣く	抑制単語	咽び泣く
むだぐちをたたか	無駄口をたたか	抑制単語	無駄口を叩か
むだぐちをたたく	無駄口をたたく	抑制単語	無駄口を叩く
むちうた	むち打た	抑制単語	鞭打た
むちうち	むち打ち	抑制単語	鞭打ち
むちうちし	むち打ちし	抑制単語	鞭打ちし
むちうちしょう	むちうち症	抑制単語	鞭打ち症
むちうちしょう	むち打ち症	抑制単語	鞭打ち症
むちうっ	むち打っ	抑制単語	鞭打っ
むちうつ	むち打つ	抑制単語	鞭打つ
むなくそ	胸くそ	抑制単語	胸糞
むなくそわる	胸くそ悪	抑制単語	胸糞悪
むなくそわるい	胸くそ悪い	抑制単語	胸糞悪い
むなくそわるかっ	胸くそ悪かっ	抑制単語	胸糞悪かっ
むなくそわるく	胸くそ悪く	抑制単語	胸糞悪く
むなくそわるさ	胸くそ悪さ	抑制単語	胸糞悪さ
むなぐらをつかま	胸ぐらをつかま	抑制単語	胸ぐらを掴ま
むなぐらをつかま	胸ぐらをつかま	抑制単語	胸倉を掴ま
むなぐらをつかま	胸倉をつかま	抑制単語	胸倉を掴ま
むなぐらをつかみ	胸ぐらをつかみ	抑制単語	胸ぐらを掴み
むなぐらをつかむ	胸ぐらをつかむ	抑制単語	胸ぐらを掴む
むなぐらをつかむ	胸ぐらをつかむ	抑制単語	胸倉を掴む
むなぐらをつかむ	胸倉をつかむ	抑制単語	胸倉を掴む
むなぐらをつかん	胸ぐらをつかん	抑制単語	胸ぐらを掴ん
むなぐらをつかん	胸ぐらをつかん	抑制単語	胸倉を掴ん
むなぐらをつかん	胸倉をつかん	抑制単語	胸倉を掴ん
むなびれ	胸びれ	抑制単語	胸鰭
むねをたたい	胸をたたい	抑制単語	胸を叩い
むねをたたき	胸をたたき	抑制単語	胸を叩き
むねをたたく	胸をたたく	抑制単語	胸を叩く
むねをなでおろし	胸をなでおろし	抑制単語	胸を撫でおろし
むねをなでおろし	胸をなでおろし	抑制単語	胸を撫で下ろし
むねをなでおろし	胸をなで下ろし	抑制単語	胸を撫で下ろし
むねをなでおろす	胸をなでおろす	抑制単語	胸を撫でおろす
むねをなでおろす	胸をなでおろす	抑制単語	胸を撫で下ろす
むねをなでおろす	胸をなで下ろす	抑制単語	胸を撫で下ろす
むろか	無ろ過	抑制単語	無濾過
むろかせい	無ろ過生	抑制単語	無濾過生
めいきょくぞろい	名曲ぞろい	抑制単語	名曲揃い
めいせき	明せき	抑制単語	明晰
めいそう	めい想	抑制単語	冥想
めいそう	めい想	抑制単語	瞑想
めいふく	めい福	抑制単語	冥福
めいりょう	明りょう	抑制単語	明瞭
めいわきやく	名わき役	抑制単語	名脇役
めかゆ	目かゆ	抑制単語	目痒
めかゆい	目かゆい	抑制単語	目痒い
めかゆく	目かゆく	抑制単語	目痒く
めからうろこがおち	目からうろこが落ち	抑制単語	目から鱗が落ち
めからうろこがおちる	目からうろこが落ちる	抑制単語	目から鱗が落ちる
めがさえ	目がさえ	抑制単語	目が冴え
めがさえちゃっ	目がさえちゃっ	抑制単語	目が冴えちゃっ
めがさえる	目がさえる	抑制単語	目が冴える
めくそ	目くそ	抑制単語	目糞
めくそはなくそ	目くそ鼻くそ	抑制単語	目糞鼻糞
めくりあげ	めくり上げ	抑制単語	捲り上げ
めくれあがっ	めくれ上がっ	抑制単語	捲れ上がっ
めくれあがり	めくれ上がり	抑制単語	捲れ上がり
めくれあがる	めくれ上がる	抑制単語	捲れ上がる
めぐみあふれる	恵みあふれる	抑制単語	恵み溢れる
めぐみにあふれ	恵みにあふれ	抑制単語	恵みに溢れ
めぐりあえ	巡りあえ	抑制単語	巡り逢え
めぐりあえ	巡りあえ	抑制単語	巡り逢え
めぐりあえる	巡りあえる	抑制単語	巡り逢える
めぐりめぐる	巡りめぐる	抑制単語	巡り廻る
めざとい	目ざとい	抑制単語	目聡い
めざとく	目ざとく	抑制単語	目聡く
めしあがりいただけ	召しあがり頂け	抑制単語	召し上がり戴け
めしあがりいただけ	召し上がりいただけ	抑制単語	召し上がり戴け
めしびつ	飯びつ	抑制単語	飯櫃
めしべ	雌しべ	抑制単語	雌蕊
めじり	目じり	抑制単語	目尻
めびな	女びな	抑制単語	女雛
めまい	目まい	抑制単語	目眩
めをむい	目をむい	抑制単語	目を剥い
めをむき	目をむき	抑制単語	目を剥き
めをむく	目をむく	抑制単語	目を剥く
めんたべ	めん食べ	抑制単語	麺食べ
めんどころ	めん処	抑制単語	麺処
めんば	面ば	抑制単語	面罵
めんぼう	めん棒	抑制単語	麺棒
めんるい	めん類	抑制単語	麺類
もうきん	猛きん	抑制単語	猛禽
もうせん	毛せん	抑制単語	毛氈
もうそうたくましい	妄想たくましい	抑制単語	妄想逞しい
もうそうたくましく	妄想たくましく	抑制単語	妄想逞しく
もえぎいろ	もえぎ色	抑制単語	萌葱色
もえたぎっ	燃えたぎっ	抑制単語	燃え滾っ
もえたぎら	燃えたぎら	抑制単語	燃え滾ら
もえたぎり	燃えたぎり	抑制単語	燃え滾り
もえたぎる	燃えたぎる	抑制単語	燃え滾る
もえで	もえ出	抑制単語	萌え出
もくず	藻くず	抑制単語	藻屑
もくと	目と	抑制単語	目睹
もくとう	黙とう	抑制単語	黙祷
もくとう	黙とう	抑制単語	黙禱
もくよく	もく浴	抑制単語	沐浴
もしゃ	も写	抑制単語	摸写
もぞう	も造	抑制単語	摸造
もたれかかっ	もたれ掛かっ	抑制単語	凭れ掛かっ
もたれかかり	もたれ掛かり	抑制単語	凭れ掛かり
もたれかかる	もたれ掛かる	抑制単語	凭れ掛かる
もだえくるしみ	もだえ苦しみ	抑制単語	悶え苦しみ
もだえくるしむ	もだえ苦しむ	抑制単語	悶え苦しむ
もだえくるしん	もだえ苦しん	抑制単語	悶え苦しん
もちがし	もち菓子	抑制単語	餅菓子
もちきり	持ち切り	抑制単語	餅切り
もちごめ	もち米	抑制単語	糯米
もちごめ	もち米	抑制単語	餅米
もちのき	もちの木	抑制単語	黐の木
もちはだ	もち肌	抑制単語	餅肌
もちや	もち屋	抑制単語	餅屋
もちろんいちばん	もちろん一番	抑制単語	勿論一番
もちろんいちぶ	もちろん一部	抑制単語	勿論一部
もちろんいま	もちろん今	抑制単語	勿論今
もちろんおおく	もちろん多く	抑制単語	勿論多く
もちろんかこ	もちろん過去	抑制単語	勿論過去
もちろんきほん	もちろん基本	抑制単語	勿論基本
もちろんきょう	もちろん今日	抑制単語	勿論今日
もちろんけっか	もちろん結果	抑制単語	勿論結果
もちろんげんざい	もちろん現在	抑制単語	勿論現在
もちろんことし	もちろん今年	抑制単語	勿論今年
もちろんこんかい	もちろん今回	抑制単語	勿論今回
もちろんこんご	もちろん今後	抑制単語	勿論今後
もちろんさいご	もちろん最後	抑制単語	勿論最後
もちろんさいしょ	もちろん最初	抑制単語	勿論最初
もちろんじかん	もちろん時間	抑制単語	勿論時間
もちろんじぶん	もちろん自分	抑制単語	勿論自分
もちろんすべて	もちろん全て	抑制単語	勿論全て
もちろんぜったい	もちろん絶対	抑制単語	勿論絶対
もちろんぜんいん	もちろん全員	抑制単語	勿論全員
もちろんぜんぶ	もちろん全部	抑制単語	勿論全部
もちろんそのご	もちろんその後	抑制単語	勿論その後
もちろんたくさん	もちろん沢山	抑制単語	勿論沢山
もちろんつうじょう	もちろん通常	抑制単語	勿論通常
もちろんつぎ	もちろん次	抑制単語	勿論次
もちろんとうじ	もちろん当時	抑制単語	勿論当時
もちろんとうじつ	もちろん当日	抑制単語	勿論当日
もちろんとちゅう	もちろん途中	抑制単語	勿論途中
もちろんふだん	もちろん普段	抑制単語	勿論普段
もちろんへいじつ	もちろん平日	抑制単語	勿論平日
もちろんまいにち	もちろん毎日	抑制単語	勿論毎日
もちろんまえ	もちろん前	抑制単語	勿論前
もちろんみなさん	もちろん皆さん	抑制単語	勿論皆さん
もちろんむかし	もちろん昔	抑制単語	勿論昔
もちろんよる	もちろん夜	抑制単語	勿論夜
もちろんりょうほう	もちろん両方	抑制単語	勿論両方
もっけのさいわい	もっけの幸い	抑制単語	勿怪の幸い
もつれこみ	もつれ込み	抑制単語	縺れ込み
もつれこむ	もつれ込む	抑制単語	縺れ込む
もつれこん	もつれ込ん	抑制単語	縺れ込ん
もとくま	元くま	抑制単語	元熊
もとさや	元さや	抑制単語	元鞘
もとだんな	元だんな	抑制単語	元旦那
もとつめ	元詰め	抑制単語	元爪
もととら	元とら	抑制単語	元虎
もとのもくあみ	元のもくあみ	抑制単語	元の木阿弥
もとめさまよう	求めさまよう	抑制単語	求め彷徨う
もともとあおい	もともと青い	抑制単語	元々青い
もともとあかい	もともと赤い	抑制単語	元々赤い
もともとあかるい	もともと明るい	抑制単語	元々明るい
もともとあかるかっ	もともと明るかっ	抑制単語	元々明るかっ
もともとあかるく	もともと明るく	抑制単語	元々明るく
もともとあきっぽい	もともと飽きっぽい	抑制単語	元々飽きっぽい
もともとあさい	もともと浅い	抑制単語	元々浅い
もともとあたたかい	もともと暖かい	抑制単語	元々暖かい
もともとあたらしい	もともと新しい	抑制単語	元々新しい
もともとあつい	もともと厚い	抑制単語	元々厚い
もともとあつい	もともと暑い	抑制単語	元々暑い
もともとあつい	もともと熱い	抑制単語	元々熱い
もともとあぶない	もともと危ない	抑制単語	元々危ない
もともとあま	もともと甘	抑制単語	元々甘
もともとあまい	もともと甘い	抑制単語	元々甘い
もともとあやしい	もともと怪しい	抑制単語	元々怪しい
もともとあわい	もともと淡い	抑制単語	元々淡い
もともといい	もともと良い	抑制単語	元々良い
もともといそがしい	もともと忙しい	抑制単語	元々忙しい
もともといたい	もともと痛い	抑制単語	元々痛い
もともといたかっ	もともと痛かっ	抑制単語	元々痛かっ
もともとうすい	もともと薄い	抑制単語	元々薄い
もともとうすかっ	もともと薄かっ	抑制単語	元々薄かっ
もともとうすく	もともと薄く	抑制単語	元々薄く
もともとうつくしい	もともと美しい	抑制単語	元々美しい
もともとうまい	もともと上手い	抑制単語	元々上手い
もともとうまかっ	もともと上手かっ	抑制単語	元々上手かっ
もともとうまく	もともと上手く	抑制単語	元々上手く
もともとおいしい	もともと美味しい	抑制単語	元々美味しい
もともとおおい	もともと多い	抑制単語	元々多い
もともとおおかっ	もともと多かっ	抑制単語	元々多かっ
もともとおおきい	もともと大きい	抑制単語	元々大きい
もともとおおきかっ	もともと大きかっ	抑制単語	元々大きかっ
もともとおおきく	もともと大きく	抑制単語	元々大きく
もともとおおく	もともと多く	抑制単語	元々多く
もともとおさない	もともと幼い	抑制単語	元々幼い
もともとおそい	もともと遅い	抑制単語	元々遅い
もともとおとなしい	もともと大人しい	抑制単語	元々大人しい
もともとおもい	もともと重い	抑制単語	元々重い
もともとおもしろい	もともと面白い	抑制単語	元々面白い
もともとおもしろく	もともと面白く	抑制単語	元々面白く
もともとおもたい	もともと重たい	抑制単語	元々重たい
もともとおやすい	もともとお安い	抑制単語	元々お安い
もともとかしこい	もともと賢い	抑制単語	元々賢い
もともとかずすくない	もともと数少ない	抑制単語	元々数少ない
もともとかたい	もともと固い	抑制単語	元々固い
もともとかたい	もともと堅い	抑制単語	元々堅い
もともとかたい	もともと硬い	抑制単語	元々硬い
もともとかたく	もともと硬く	抑制単語	元々硬く
もともとからい	もともと辛い	抑制単語	元々辛い
もともとかるい	もともと軽い	抑制単語	元々軽い
もともとかるく	もともと軽く	抑制単語	元々軽く
もともとかわいい	もともと可愛い	抑制単語	元々可愛い
もともとかわいかっ	もともと可愛かっ	抑制単語	元々可愛かっ
もともとかわいく	もともと可愛く	抑制単語	元々可愛く
もともとかわいらしい	もともと可愛らしい	抑制単語	元々可愛らしい
もともとかんけいない	もともと関係ない	抑制単語	元々関係ない
もともときいろい	もともと黄色い	抑制単語	元々黄色い
もともときたない	もともと汚い	抑制単語	元々汚い
もともときびしい	もともと厳しい	抑制単語	元々厳しい
もともときもちわるい	もともと気持ち悪い	抑制単語	元々気持ち悪い
もともとくさい	もともと臭い	抑制単語	元々臭い
もともとくらい	もともと暗い	抑制単語	元々暗い
もともとくろい	もともと黒い	抑制単語	元々黒い
もともとくろかっ	もともと黒かっ	抑制単語	元々黒かっ
もともとくろっぽい	もともと黒っぽい	抑制単語	元々黒っぽい
もともとくわしく	もともと詳しく	抑制単語	元々詳しく
もともとけぶかい	もともと毛深い	抑制単語	元々毛深い
もともとけぶかく	もともと毛深く	抑制単語	元々毛深く
もともとこい	もともと濃い	抑制単語	元々濃い
もともとこく	もともと濃く	抑制単語	元々濃く
もともとこまかい	もともと細かい	抑制単語	元々細かい
もともとこわい	もともと怖い	抑制単語	元々怖い
もともとさむ	もともと寒	抑制単語	元々寒
もともとさむい	もともと寒い	抑制単語	元々寒い
もともとしたしい	もともと親しい	抑制単語	元々親しい
もともとしぶい	もともと渋い	抑制単語	元々渋い
もともとしょくがほそい	もともと食が細い	抑制単語	元々食が細い
もともとしょくがほそく	もともと食が細く	抑制単語	元々食が細く
もともとしろい	もともと白い	抑制単語	元々白い
もともとしろかっ	もともと白かっ	抑制単語	元々白かっ
もともとしろく	もともと白く	抑制単語	元々白く
もともとしろっぽい	もともと白っぽい	抑制単語	元々白っぽい
もともとすくない	もともと少ない	抑制単語	元々少ない
もともとすくなかっ	もともと少なかっ	抑制単語	元々少なかっ
もともとすくなく	もともと少なく	抑制単語	元々少なく
もともとすばらしい	もともと素晴らしい	抑制単語	元々素晴らしい
もともとせまい	もともと狭い	抑制単語	元々狭い
もともとせまく	もともと狭く	抑制単語	元々狭く
もともとたか	もともと高	抑制単語	元々高
もともとたかい	もともと高い	抑制単語	元々高い
もともとたかかっ	もともと高かっ	抑制単語	元々高かっ
もともとたかく	もともと高く	抑制単語	元々高く
もともとただしい	もともと正しい	抑制単語	元々正しい
もともとたのしい	もともと楽しい	抑制単語	元々楽しい
もともとちいさい	もともと小さい	抑制単語	元々小さい
もともとちいさかっ	もともと小さかっ	抑制単語	元々小さかっ
もともとちいさく	もともと小さく	抑制単語	元々小さく
もともとちかい	もともと近い	抑制単語	元々近い
もともとちゃいろい	もともと茶色い	抑制単語	元々茶色い
もともとつめたい	もともと冷たい	抑制単語	元々冷たい
もともとつよい	もともと強い	抑制単語	元々強い
もともとつよかっ	もともと強かっ	抑制単語	元々強かっ
もともとつよく	もともと強く	抑制単語	元々強く
もともとつらい	もともと辛い	抑制単語	元々辛い
もともととおい	もともと遠い	抑制単語	元々遠い
もともとない	もともと無い	抑制単語	元々無い
もともとなかっ	もともと無かっ	抑制単語	元々無かっ
もともとなかよかっ	もともと仲良かっ	抑制単語	元々仲良かっ
もともとなかよく	もともと仲良く	抑制単語	元々仲良く
もともとながい	もともと長い	抑制単語	元々長い
もともとながかっ	もともと長かっ	抑制単語	元々長かっ
もともとながく	もともと長く	抑制単語	元々長く
もともとなく	もともと無く	抑制単語	元々無く
もともとなみだもろい	もともと涙もろい	抑制単語	元々涙もろい
もともとにぶい	もともと鈍い	抑制単語	元々鈍い
もともとはげしい	もともと激しい	抑制単語	元々激しい
もともとはやい	もともと早い	抑制単語	元々早い
もともとはやい	もともと速い	抑制単語	元々速い
もともとはやく	もともと早く	抑制単語	元々早く
もともとはやく	もともと速く	抑制単語	元々速く
もともとひくい	もともと低い	抑制単語	元々低い
もともとひくかっ	もともと低かっ	抑制単語	元々低かっ
もともとひくく	もともと低く	抑制単語	元々低く
もともとひとなつっこい	もともと人懐っこい	抑制単語	元々人懐っこい
もともとひどい	もともと酷い	抑制単語	元々酷い
もともとひろい	もともと広い	抑制単語	元々広い
もともとひろかっ	もともと広かっ	抑制単語	元々広かっ
もともとひろく	もともと広く	抑制単語	元々広く
もともとふかい	もともと深い	抑制単語	元々深い
もともとふかく	もともと深く	抑制単語	元々深く
もともとふとい	もともと太い	抑制単語	元々太い
もともとふとく	もともと太く	抑制単語	元々太く
もともとふるい	もともと古い	抑制単語	元々古い
もともとほしい	もともと欲しい	抑制単語	元々欲しい
もともとほしかっ	もともと欲しかっ	抑制単語	元々欲しかっ
もともとほしく	もともと欲しく	抑制単語	元々欲しく
もともとほそい	もともと細い	抑制単語	元々細い
もともとほそかっ	もともと細かっ	抑制単語	元々細かっ
もともとほそく	もともと細く	抑制単語	元々細く
もともとまずしい	もともと貧しい	抑制単語	元々貧しい
もともとまるい	もともと丸い	抑制単語	元々丸い
もともとみじかい	もともと短い	抑制単語	元々短い
もともとみじかかっ	もともと短かっ	抑制単語	元々短かっ
もともとみじかく	もともと短く	抑制単語	元々短く
もともとむずかしい	もともと難しい	抑制単語	元々難しい
もともとやさしい	もともと優しい	抑制単語	元々優しい
もともとやすい	もともと安い	抑制単語	元々安い
もともとやすかっ	もともと安かっ	抑制単語	元々安かっ
もともとやすく	もともと安く	抑制単語	元々安く
もともとやわらかい	もともと柔らかい	抑制単語	元々柔らかい
もともとやわらかく	もともと柔らかく	抑制単語	元々柔らかく
もともとゆるい	もともと緩い	抑制単語	元々緩い
もともとよい	もともと良い	抑制単語	元々良い
もともとよかっ	もともと良かっ	抑制単語	元々良かっ
もともとよく	もともと良く	抑制単語	元々良く
もともとよわい	もともと弱い	抑制単語	元々弱い
もともとよわかっ	もともと弱かっ	抑制単語	元々弱かっ
もともとよわく	もともと弱く	抑制単語	元々弱く
もともとわかい	もともと若い	抑制単語	元々若い
もともとわかく	もともと若く	抑制単語	元々若く
もともとわるい	もともと悪い	抑制単語	元々悪い
もともとわるかっ	もともと悪かっ	抑制単語	元々悪かっ
もともとわるく	もともと悪く	抑制単語	元々悪く
ものおもいにふけっ	物思いにふけっ	抑制単語	物思いに耽っ
ものごい	物ごい	抑制単語	物乞い
ものすご	物すご	抑制単語	物凄
ものすごい	物すごい	抑制単語	物凄い
ものすごいいきおい	ものすごい勢い	抑制単語	もの凄い勢い
ものすごいいきおい	ものすごい勢い	抑制単語	物凄い勢い
ものすごいおと	ものすごい音	抑制単語	物凄い音
ものすごいかず	ものすごい数	抑制単語	もの凄い数
ものすごいかず	ものすごい数	抑制単語	物凄い数
ものすごいひと	ものすごい人	抑制単語	物凄い人
ものすごいりょう	ものすごい量	抑制単語	物凄い量
ものすごく	物すごく	抑制単語	物凄く
ものすごくごのみ	ものすごく好み	抑制単語	物凄く好み
もほん	も本	抑制単語	摸本
もみあい	もみ合い	抑制単語	揉み合い
もみあう	もみ合う	抑制単語	揉み合う
もみあげ	もみ上げ	抑制単語	揉み上げ
もみあっ	もみ合っ	抑制単語	揉み合っ
もみあらい	もみ洗い	抑制単語	揉み洗い
もみあわ	もみ合わ	抑制単語	揉み合わ
もみかわ	もみ革	抑制単語	揉み革
もみがら	もみ殻	抑制単語	籾殻
もみけさ	もみ消さ	抑制単語	揉み消さ
もみけし	もみ消し	抑制単語	揉み消し
もみけしし	もみ消しし	抑制単語	揉み消しし
もみけす	もみ消す	抑制単語	揉み消す
もみけせ	もみ消せ	抑制単語	揉み消せ
もみけせ	もみ消せ	抑制単語	揉み消せ
もみけせる	もみ消せる	抑制単語	揉み消せる
もみけそ	もみ消そ	抑制単語	揉み消そ
もみこま	もみ込ま	抑制単語	揉み込ま
もみこみ	もみ込み	抑制単語	揉み込み
もみこむ	もみ込む	抑制単語	揉み込む
もみこめ	もみ込め	抑制単語	揉み込め
もみこん	もみ込ん	抑制単語	揉み込ん
もみだし	もみ出し	抑制単語	揉み出し
もみて	もみ手	抑制単語	揉み手
もみまぜ	もみ混ぜ	抑制単語	揉み混ぜ
もめごと	もめ事	抑制単語	揉め事
ももにく	もも肉	抑制単語	腿肉
もらいあつめ	もらい集め	抑制単語	貰い集め
もらいうけ	もらい受け	抑制単語	貰い受け
もらいうける	もらい受ける	抑制単語	貰い受ける
もらいかえっ	もらい帰っ	抑制単語	貰い帰っ
もらいかえり	もらい帰り	抑制単語	貰い帰り
もらいご	もらい子	抑制単語	貰い子
もらいそこなっ	もらい損なっ	抑制単語	貰い損なっ
もらいそこね	もらい損ね	抑制単語	貰い損ね
もらいそこねる	もらい損ねる	抑制単語	貰い損ねる
もらいたべ	もらい食べ	抑制単語	貰い食べ
もらいためし	もらい試し	抑制単語	貰い試し
もらいちち	もらい乳	抑制単語	貰い乳
もらいつかっ	もらい使っ	抑制単語	貰い使っ
もらいて	もらい手	抑制単語	貰い手
もらいなき	もらい泣き	抑制単語	貰い泣き
もらいなれ	もらい慣れ	抑制単語	貰い慣れ
もらいにいき	もらいに行き	抑制単語	貰いに行き
もらいにいく	もらいに行く	抑制単語	貰いに行く
もらいにいこ	もらいに行こ	抑制単語	貰いに行こ
もらいにいっ	もらいに行っ	抑制単語	貰いに行っ
もらいにき	もらいに来	抑制単語	貰いに来
もらいにげ	もらい逃げ	抑制単語	貰い逃げ
もらいぬっ	もらい塗っ	抑制単語	貰い塗っ
もらいのま	もらい飲ま	抑制単語	貰い飲ま
もらいのみ	もらい飲み	抑制単語	貰い飲み
もらいのん	もらい飲ん	抑制単語	貰い飲ん
もらいび	もらい火	抑制単語	貰い火
もらいほうだい	もらい放題	抑制単語	貰い放題
もらいみ	もらい見	抑制単語	貰い見
もらいみず	もらい水	抑制単語	貰い水
もらいもの	もらい物	抑制単語	貰い物
もらいゆ	もらい湯	抑制単語	貰い湯
もらいよろこん	もらい喜ん	抑制単語	貰い喜ん
もらいわすれ	もらい忘れ	抑制単語	貰い忘れ
もらいわすれ	もらい忘れ	抑制単語	貰い忘れ
もらいわすれる	もらい忘れる	抑制単語	貰い忘れる
もりそば	盛りそば	抑制単語	盛蕎麦
もれきこえ	もれ聞こえ	抑制単語	洩れ聞こえ
もれで	もれ出	抑制単語	洩れ出
もれでる	もれ出る	抑制単語	洩れ出る
もろもろのこと	もろもろの事	抑制単語	諸々の事
もろもろふくめ	もろもろ含め	抑制単語	諸々含め
もんぜつ	もん絶	抑制単語	悶絶
やがすり	矢がすり	抑制単語	矢絣
やきぎょうざ	焼きぎょうざ	抑制単語	焼き餃子
やきごて	焼きごて	抑制単語	焼鏝
やきざかな	焼き魚	抑制単語	焼肴
やきつぶし	焼きつぶし	抑制単語	焼き潰し
やきつぶす	焼きつぶす	抑制単語	焼き潰す
やきのり	焼のり	抑制単語	焼海苔
やきはまぐり	焼はまぐり	抑制単語	焼蛤
やきもち	焼きもち	抑制単語	焼き餅
やきもち	焼きもち	抑制単語	焼餅
やきもちをやい	やきもちを焼い	抑制単語	焼き餅を焼い
やきもちをやい	焼きもちを焼い	抑制単語	焼き餅を焼い
やきもちをやく	やきもちを焼く	抑制単語	焼き餅を焼く
やきもちをやく	焼きもちを焼く	抑制単語	焼き餅を焼く
やくしゃがそろい	役者がそろい	抑制単語	役者が揃い
やくしゃがそろっ	役者がそろっ	抑制単語	役者が揃っ
やぐらだいこ	やぐら太鼓	抑制単語	櫓太鼓
やけただれ	焼けただれ	抑制単語	焼け爛れ
やけただれる	焼けただれる	抑制単語	焼け爛れる
やけぼっくい	焼けぼっくい	抑制単語	焼け木杭
やじり	矢じり	抑制単語	矢尻
やせおとろえ	やせ衰え	抑制単語	痩せ衰え
やせち	やせ地	抑制単語	痩せ地
やせほそっ	やせ細っ	抑制単語	痩せ細っ
やせほそら	やせ細ら	抑制単語	痩せ細ら
やせほそり	やせ細り	抑制単語	痩せ細り
やせほそる	やせ細る	抑制単語	痩せ細る
やたいばやし	屋台ばやし	抑制単語	屋台囃子
やっきょう	薬きょう	抑制単語	薬莢
やねふき	屋根ふき	抑制単語	屋根葺き
やぶいしゃ	やぶ医者	抑制単語	薮医者
やぶいしゃ	やぶ医者	抑制単語	藪医者
やぶへび	やぶ蛇	抑制単語	薮蛇
やぶへび	やぶ蛇	抑制単語	藪蛇
やまごもり	山ごもり	抑制単語	山篭り
やまごもり	山ごもり	抑制単語	山籠り
やますそ	山すそ	抑制単語	山裾
やまとえ	やまと絵	抑制単語	倭絵
やまとなでしこ	大和なでしこ	抑制単語	大和撫子
やまひだ	山ひだ	抑制単語	山襞
やまびこ	山びこ	抑制単語	山彦
やみいち	やみ市	抑制単語	闇市
やみや	やみ屋	抑制単語	闇屋
やみよ	やみ夜	抑制単語	闇夜
やむなく	やむ無く	抑制単語	已む無く
やりだま	やり玉	抑制単語	槍玉
やりだまにあがっ	やり玉に挙がっ	抑制単語	槍玉にあがっ
やりだまにあがっ	やり玉に挙がっ	抑制単語	槍玉に上がっ
やりだまにあがっ	やり玉に挙がっ	抑制単語	槍玉に挙がっ
やりだまにあがる	やり玉に挙がる	抑制単語	槍玉にあがる
やりだまにあがる	やり玉に挙がる	抑制単語	槍玉に上がる
やりだまにあがる	やり玉に挙がる	抑制単語	槍玉に挙がる
やりだまにあげ	やり玉に挙げ	抑制単語	槍玉にあげ
やりだまにあげ	やり玉に挙げ	抑制単語	槍玉に上げ
やりだまにあげ	やり玉に挙げ	抑制単語	槍玉に挙げ
やりだまにあげ	やり玉に挙げ	抑制単語	槍玉にあげ
やりだまにあげ	やり玉に挙げ	抑制単語	槍玉に上げ
やりだまにあげ	やり玉に挙げ	抑制単語	槍玉に挙げ
やりだまにあげる	やり玉に挙げる	抑制単語	槍玉にあげる
やりだまにあげる	やり玉に挙げる	抑制単語	槍玉に上げる
やりだまにあげる	やり玉に挙げる	抑制単語	槍玉に挙げる
ゆあか	湯あか	抑制単語	湯垢
ゆううつ	憂うつ	抑制単語	憂鬱
ゆううつ	憂うつ	抑制単語	憂鬱
ゆううつかん	憂うつ感	抑制単語	憂鬱感
ゆうがたごろ	夕方ごろ	抑制単語	夕方頃
ゆうげ	夕げ	抑制単語	夕餉
ゆうしゅつ	ゆう出	抑制単語	涌出
ゆうしゅつ	ゆう出	抑制単語	湧出
ゆうなぎ	夕なぎ	抑制単語	夕凪
ゆうやみ	夕やみ	抑制単語	夕闇
ゆうわ	ゆう和	抑制単語	宥和
ゆがい	湯がい	抑制単語	湯掻い
ゆがか	湯がか	抑制単語	湯掻か
ゆがき	湯がき	抑制単語	湯掻き
ゆがく	湯がく	抑制単語	湯掻く
ゆきあい	行きあい	抑制単語	行き逢い
ゆきあう	行きあう	抑制単語	行き逢う
ゆきあっ	行きあっ	抑制単語	行き逢っ
ゆきうさぎ	雪うさぎ	抑制単語	雪兎
ゆきかき	雪かき	抑制単語	雪掻き
ゆきたけ	ゆき丈	抑制単語	裄丈
ゆずちゃ	ゆず茶	抑制単語	柚子茶
ゆずふうみ	ゆず風味	抑制単語	柚子風味
ゆずゆ	ゆず湯	抑制単語	柚子湯
ゆずりいただき	譲りいただき	抑制単語	譲り戴き
ゆせん	湯せん	抑制単語	湯煎
ゆであがり	ゆで上がり	抑制単語	茹で上がり
ゆであげ	ゆで上げ	抑制単語	茹で上げ
ゆでおき	ゆで置き	抑制単語	茹で置き
ゆでかげん	ゆで加減	抑制単語	茹で加減
ゆでたまご	ゆで卵	抑制単語	茹で卵
ゆでにく	ゆで肉	抑制単語	茹で肉
ゆでにわとり	ゆで鶏	抑制単語	茹で鶏
ゆでぶた	ゆで豚	抑制単語	茹で豚
ゆでまめ	ゆで豆	抑制単語	茹で豆
ゆでゆ	ゆで湯	抑制単語	茹で湯
ゆのみ	湯のみ	抑制単語	湯呑
ゆのみ	湯のみ	抑制単語	湯呑み
ゆのみ	湯飲み	抑制単語	湯呑
ゆびくわえ	指くわえ	抑制単語	指咥え
ゆめかなえ	夢かなえ	抑制単語	夢叶え
ゆめまくら	夢まくら	抑制単語	夢枕
ゆもみ	湯もみ	抑制単語	湯揉み
ゆりかご	揺りかご	抑制単語	揺り篭
ゆりかご	揺りかご	抑制単語	揺り籠
よいざめ	酔いざめ	抑制単語	酔い醒め
よいつぶれ	酔いつぶれ	抑制単語	酔い潰れ
よいつぶれ	酔いつぶれ	抑制単語	酔い潰れ
よいつぶれる	酔いつぶれる	抑制単語	酔い潰れる
ようか	よう化	抑制単語	沃化
ようか	よう化	抑制単語	蛹化
ようかん	羊かん	抑制単語	羊羹
ようさい	要さい	抑制単語	要塞
ようし	よう死	抑制単語	夭死
ようすをうかがい	様子をうかがい	抑制単語	様子を窺い
ようすをうかがう	様子をうかがう	抑制単語	様子を窺う
ようすをうかがっ	様子をうかがっ	抑制単語	様子を窺っ
ようせん	よう船	抑制単語	傭船
ようせん	用せん	抑制単語	用箋
ようぼう	容ぼう	抑制単語	容貌
よくうつ	抑うつ	抑制単語	抑鬱
よくにめがくらみ	欲に目がくらみ	抑制単語	欲に目が眩み
よくにめがくらむ	欲に目がくらむ	抑制単語	欲に目が眩む
よくにめがくらん	欲に目がくらん	抑制単語	欲に目が眩ん
よこばい	横ばい	抑制単語	横這い
よこやりをいれ	横やりを入れ	抑制単語	横槍を入れ
よこやりをいれ	横やりを入れ	抑制単語	横槍を入れ
よこやりをいれる	横やりを入れる	抑制単語	横槍を入れる
よじごろ	四時ごろ	抑制単語	四時頃
よじのぼっ	よじ登っ	抑制単語	攀じ登っ
よじのぼり	よじ登り	抑制単語	攀じ登り
よじのぼる	よじ登る	抑制単語	攀じ登る
よだれをたらし	よだれを垂らし	抑制単語	涎を垂らし
よだれをたらす	よだれを垂らす	抑制単語	涎を垂らす
よつんばい	四つんばい	抑制単語	四つん這い
よねんごろ	四年ごろ	抑制単語	四年頃
よのなかなめ	世の中なめ	抑制単語	世の中舐め
よびだしくらう	呼び出しくらう	抑制単語	呼び出し喰らう
よびだしくらっ	呼び出しくらっ	抑制単語	呼び出し喰らっ
よみいただけ	読みいただけ	抑制単語	読み戴け
よみいただけれ	読みいただけれ	抑制単語	読み戴けれ
よみかじっ	読みかじっ	抑制単語	読み齧っ
よみふけっ	読みふけっ	抑制単語	読み耽っ
よみふけり	読みふけり	抑制単語	読み耽り
よみふける	読みふける	抑制単語	読み耽る
よゆうしゃくしゃく	余裕しゃくしゃく	抑制単語	余裕綽々
よゆうしゃくしゃく	余裕しゃくしゃく	抑制単語	余裕綽綽
よりあわさ	より合わさ	抑制単語	撚り合わさ
よりあわせ	より合わせ	抑制単語	撚り合わせ
よりあわせ	より合わせ	抑制単語	縒り合わせ
よりあわせる	より合わせる	抑制単語	撚り合わせる
よりいと	より糸	抑制単語	撚り糸
よりいと	より糸	抑制単語	縒り糸
よろいど	よろい戸	抑制単語	鎧戸
よろこびあふれ	喜びあふれ	抑制単語	喜び溢れ
よろこびあふれる	喜びあふれる	抑制単語	喜び溢れる
よろこびかみしめ	喜びかみしめ	抑制単語	喜び噛み締め
よろこびにあふれ	喜びにあふれ	抑制単語	喜びに溢れ
よろこびにあふれる	喜びにあふれる	抑制単語	喜びに溢れる
よろこびにつながる	喜びにつながる	抑制単語	喜びに繋がる
よろこびにみちあふれ	喜びに満ちあふれ	抑制単語	喜びに満ち溢れ
よろこびにわく	喜びにわく	抑制単語	喜びに湧く
よわきをたすけつよきをくじく	弱きを助け強きをくじく	抑制単語	弱きを助け強きを挫く
らいこう	来こう	抑制単語	来寇
らいさん	礼さん	抑制単語	礼讃
らいさん	礼さん	抑制単語	礼讚
らいねんなつごろ	来年夏ごろ	抑制単語	来年夏頃
らいびょう	らい病	抑制単語	癩病
らいらく	らい落	抑制単語	磊落
らくいん	らく印	抑制単語	烙印
らせんかいだん	らせん階段	抑制単語	螺旋階段
らせんじょう	らせん状	抑制単語	螺旋状
らち	ら致	抑制単語	拉致
らちがあか	らちが明か	抑制単語	埒が明か
らちがあき	らちが明き	抑制単語	埒が明き
らちがい	らち外	抑制単語	埒外
らつわん	らつ腕	抑制単語	辣腕
らんそうがん	卵巣がん	抑制単語	卵巣癌
らんまん	らん漫	抑制単語	爛漫
りかん	り患	抑制単語	罹患
りきそう	力そう	抑制単語	力漕
りさい	り災	抑制単語	罹災
りさいしょうめいしょ	り災証明書	抑制単語	罹災証明書
りざや	利ざや	抑制単語	利鞘
りにさとい	利にさとい	抑制単語	利に聡い
りびょう	り病	抑制単語	罹病
りふぉーむかしほけん	リフォームかし保険	抑制単語	リフォーム瑕疵保険
りゅうちょう	流ちょう	抑制単語	流暢
りゅうのひげ	竜のひげ	抑制単語	竜の髭
りょうあご	両あご	抑制単語	両顎
りょうかかと	両かかと	抑制単語	両踵
りょうこぶし	両こぶし	抑制単語	両拳
りょうしんがとがめ	良心がとがめ	抑制単語	良心が咎め
りょうせん	りょう線	抑制単語	稜線
りょうてんびん	両てんびん	抑制単語	両天秤
りょうふともも	両太もも	抑制単語	両太腿
りょうほうすごい	両方すごい	抑制単語	両方凄い
りょうまぶた	両まぶた	抑制単語	両瞼
りょうもも	両もも	抑制単語	両腿
りょうわき	両わき	抑制単語	両脇
りょこうかばん	旅行かばん	抑制単語	旅行鞄
りんかん	輪かん	抑制単語	輪姦
りんぎ	りん議	抑制単語	稟議
りんね	輪ね	抑制単語	輪廻
りんびょう	りん病	抑制単語	淋病
るいさん	類さん	抑制単語	類纂
るつぼとかし	るつぼと化し	抑制単語	坩堝と化し
るつぼとかす	るつぼと化す	抑制単語	坩堝と化す
れいきゅう	霊きゅう	抑制単語	霊柩
れんがてい	れんが亭	抑制単語	煉瓦亭
れんけい	連けい	抑制単語	連繋
れんじつすごい	連日すごい	抑制単語	連日凄い
ろうあしゃ	ろうあ者	抑制単語	聾唖者
ろうえい	漏えい	抑制単語	漏洩
ろうえいとう	漏えい等	抑制単語	漏洩等
ろうかい	老かい	抑制単語	老獪
ろうがっこう	ろう学校	抑制単語	聾学校
ろうしゃ	ろう者	抑制単語	聾者
ろうじょう	ろう城	抑制単語	牢城
ろうじょう	ろう城	抑制単語	篭城
ろうじょう	ろう城	抑制単語	籠城
ろか	ろ過	抑制単語	濾過
ろかく	ろ獲	抑制単語	鹵獲
ろかそうち	ろ過装置	抑制単語	濾過装置
ろかのうりょく	ろ過能力	抑制単語	濾過能力
ろかばくてりあ	ろ過バクテリア	抑制単語	濾過バクテリア
ろかふぃるたー	ろ過フィルター	抑制単語	濾過フィルター
ろくがつごろ	六月ごろ	抑制単語	6月頃
ろくがつごろ	六月ごろ	抑制単語	六月頃
ろくじごろ	六時ごろ	抑制単語	六時頃
ろくでもない	ろくでも無い	抑制単語	碌でも無い
ろくろくび	ろくろ首	抑制単語	轆轤首
ろし	ろ紙	抑制単語	濾紙
ろすい	ろ水	抑制単語	濾水
ろっこつ	ろっ骨	抑制単語	肋骨
わいきょく	わい曲	抑制単語	歪曲
わいざつ	わい雑	抑制単語	猥雑
わいしょう	わい小	抑制単語	矮小
わいだん	わい談	抑制単語	猥談
わかすし	若すし	抑制単語	若鮨
わかだんな	若だんな	抑制単語	若旦那
わかはげ	若はげ	抑制単語	若禿
わかりいただけ	分かりいただけ	抑制単語	分かり戴け
わかりいただけ	分りいただけ	抑制単語	分かり戴け
わかりいただける	分かりいただける	抑制単語	分かり戴ける
わかりいただける	分りいただける	抑制単語	分かり戴ける
わかりいただける	判りいただける	抑制単語	判り戴ける
わかれにつながる	別れにつながる	抑制単語	別れに繋がる
わかわかしい	若わかしい	抑制単語	若々しい
わかわかしく	若わかしく	抑制単語	若々しく
わがまま	我がまま	抑制単語	我侭
わがまま	我がまま	抑制単語	我儘
わがまま	我がまま	抑制単語	我侭
わがまま	我がまま	抑制単語	我儘
わきあいあい	和気あいあい	抑制単語	和気藹々
わきあいあい	和気合い合い	抑制単語	和気藹々
わきあがっ	沸き上がっ	抑制単語	湧き上っ
わきあがり	沸き上がり	抑制単語	湧き上り
わきあがる	沸き上がる	抑制単語	湧き上る
わきあげ	わき上げ	抑制単語	湧き上げ
わきおこっ	わき起っ	抑制単語	湧き起っ
わきげ	わき毛	抑制単語	脇毛
わきげ	わき毛	抑制単語	腋毛
わきだつもう	わき脱毛	抑制単語	脇脱毛
わきつぶし	沸きつぶし	抑制単語	沸き潰し
わきで	わき出	抑制単語	涌き出
わきで	わき出	抑制単語	湧き出
わきでる	わき出る	抑制単語	涌き出る
わきでる	わき出る	抑制単語	湧き出る
わきにく	わき肉	抑制単語	湧き肉
わきのした	わきの下	抑制単語	脇の下
わきのした	わきの下	抑制単語	腋の下
わきばら	わき腹	抑制単語	脇腹
わきみ	わき見	抑制単語	脇見
わきみず	わき水	抑制単語	涌き水
わきみず	わき水	抑制単語	湧き水
わきみず	わき水	抑制単語	湧水
わきみち	わき道	抑制単語	脇道
わきめ	わき芽	抑制単語	脇芽
わきめ	わき目	抑制単語	脇目
わきやく	わき役	抑制単語	脇役
わさびずけ	わさび漬け	抑制単語	山葵漬
わさびづけ	わさび漬け	抑制単語	山葵漬
わすれなぐさ	忘れな草	抑制単語	勿忘草
わすれなぐさ	わすれな草	抑制単語	勿忘草
わたあめ	綿あめ	抑制単語	綿飴
わたりおこなわ	わたり行なわ	抑制単語	亘り行わ
わたりおこなわ	わたり行わ	抑制単語	亘り行わ
わたりおこなわ	渡り行なわ	抑制単語	亘り行わ
わたりつちかっ	わたり培っ	抑制単語	亘り培っ
わとじ	和とじ	抑制単語	和綴じ
わのくに	和の国	抑制単語	倭国
わびじょう	わび状	抑制単語	詫び状
わびじょう	わび状	抑制単語	詫状
わびちゃ	わび茶	抑制単語	侘び茶
わらいあふれる	笑いあふれる	抑制単語	笑い溢れる
わらいにあふれ	笑いにあふれ	抑制単語	笑いに溢れ
わらいにつながっ	笑いにつながっ	抑制単語	笑いに繋がっ
わらいにつながる	笑いにつながる	抑制単語	笑いに繋がる
わらじをぬい	わらじを脱い	抑制単語	草鞋を脱い
わらにんぎょう	わら人形	抑制単語	藁人形
わらばんし	わら半紙	抑制単語	藁半紙
わりばし	割りばし	抑制単語	割り箸
わりばし	割りばし	抑制単語	割箸
わるあがき	悪あがき	抑制単語	悪足掻き
わるいうわさ	悪いうわさ	抑制単語	悪い噂
われながら	我ながら	抑制単語	我乍ら
